	ecDNA1	ecDNA2	ecDNA3
GTTTCTAGTTGCAATG-1	True	False	True
CAGGTTAGTTCCGCAC-1	False	True	True
AATCATCCATTAAACC-1	False	True	True
AAGGATCCAAATATCC-1	True	True	True
GAGCCACTCAGGTTTA-1	True	True	True
ATTAACCCACCAACCG-1	True	True	True
TGACTTAAGCGCTAAT-1	False	True	True
TAGTGTGGTTTGTTGC-1	True	True	True
CAAACTGGTGCATTAG-1	True	False	True
GTCTATGCAGGCTACT-1	True	True	True
GGAGCGATCACAGCGC-1	False	True	True
TTGCTTAGTGTTGCAA-1	True	True	True
AGTTACTCAACATAAG-1	True	True	True
CTGACATAGTTACTTC-1	False	False	True
TACAATGTCATGCAAC-1	True	True	True
AGGCGGATCCGCCTAT-1	False	True	True
CAGGGCTTCACCGGTA-1	True	True	True
AACGACAAGAGCCGCT-1	True	True	True
TTAGGCTAGCGCCTTT-1	True	True	True
GACTTAGGTCAGGCCA-1	False	True	True
AGCTAACTCGTTACTT-1	True	True	True
TACGTAATCAAAGGCA-1	True	True	True
AAGTCTATCGGGCCAT-1	True	True	True
TAATGGTGTTCAAGAT-1	False	True	True
TGAACAGAGGCGCTTA-1	True	True	True
TTCCTTCTCCTAATTC-1	True	True	True
ATGTTGTCAGGAAGCC-1	False	True	True
AGCTACTAGACTAAGG-1	True	True	True
ATGGACAAGGCGCACT-1	False	True	True
GGGTATTTCTAACCAA-1	True	True	True
ATGTTTGAGGCTCATG-1	True	False	True
ACTATGTCACCAAAGG-1	True	True	True
GTTACTAAGTTAACCA-1	True	True	True
AGAAGGTGTTAGGTTG-1	True	True	True
AGTAATGCAAAGCTAA-1	True	True	True
ACAAACTGTAATCGTG-1	False	True	True
CGCCACACACCTCAGG-1	True	True	True
CCCAAACCATTCAGCA-1	True	True	True
CGCTATGAGTAATCCA-1	False	False	True
AAACGTACAGCATGAG-1	True	True	True
CAGGCTATCTGCAAGT-1	True	True	True
TACGTTAAGCTTTGTT-1	True	True	True
GTTTGTTTCAGGTTTA-1	True	True	True
GTAAGCTTCGCCTAAG-1	True	True	True
GTCATTAAGTTATGGC-1	True	True	True
GTTCCCAGTAATCACG-1	True	True	True
CAATCGCCACATTGCA-1	True	True	True
CCTGTAACATGAAGTA-1	False	True	True
TTAGCCTGTGTTAGCA-1	False	False	True
CCTGTATGTCATGAGC-1	True	True	True
GACTTACAGCCTCTGT-1	False	True	True
TGTAAAGCATCACTTC-1	True	True	True
ACACTTGCAGTTTACG-1	True	True	True
CCAGGAACAAACATAG-1	True	True	True
GTTAACGGTTTATCGC-1	True	True	True
AAGCTAGAGCGATAGA-1	True	True	True
GCCATTACAAGGCCAA-1	True	True	True
CTATGAGGTCACAGCG-1	True	True	True
TTGCTTAGTTTAACCC-1	False	False	True
TAGCTAATCGGTCATG-1	False	False	True
CGCCTGTGTTATCCTA-1	True	True	True
CCAAATCAGACAACAG-1	True	True	True
TCTAACCGTCTATCGT-1	True	True	True
CATGGATTCAGCTAAC-1	False	True	True
ACCTAAATCAAAGGCA-1	True	True	True
ATGCCTGAGTGAACCT-1	True	True	True
AATCGCCCATGCATAT-1	True	True	True
CGGTTATAGCCGGTAC-1	True	True	True
GACCTTTGTCATGCAA-1	True	True	True
TTGCCCGTCCCTCTAA-1	True	True	True
TGTGAAACACTCAACA-1	True	True	True
GAAGTATAGGAGCATA-1	False	True	True
CCGGTTAAGTCGCTAG-1	True	True	True
CTGTTAAAGTATTGCA-1	True	True	True
TCAAGCTAGCCTGAGC-1	True	True	True
GCCAGGAAGGAGTCGG-1	True	True	True
CGCCAAATCAGCCAAT-1	False	True	True
ACGGTTTAGAGAGGAG-1	True	True	True
CTGATCACAAACGGGC-1	True	True	True
GCTGTAAGTACTGAAT-1	True	True	True
GAGTGTTTCCTGGTCT-1	True	True	True
GGTATTGGTTACCGGG-1	True	True	True
TCGTGCTTCGGCCATA-1	True	True	True
GAAACTGAGAGCCGCT-1	True	True	True
GGGCATGAGTAAGTCC-1	True	True	True
TGGTCATAGTCTGGGC-1	False	True	True
TTAACCAAGCCACAAT-1	True	True	True
ATCACTAAGAGCCGCT-1	True	True	True
TTGTCAAAGTTGTCCC-1	False	True	True
ACCACATAGCCTAATA-1	True	True	True
TGCGCGAGTTACTTCA-1	True	True	True
TGTTACTTCCAAACAC-1	True	True	True
TGCTAACAGCATGAAG-1	True	True	True
TGAAGGATCCGGAACC-1	True	True	True
ACCTGGTCAAACTGCC-1	True	True	True
GATGCAGCACCTACTT-1	True	True	True
AATTAGCGTTAACACG-1	True	True	True
TATTGACCAACCGCCA-1	True	True	True
ACCCAACCAGAAACGT-1	True	True	True
GACCTAGTCCCGCCTA-1	True	True	True
CCAAGGCTCTAGCTAA-1	True	True	True
CATCACACATCCAGGT-1	True	True	True
TGAGCCGGTTTGAGCA-1	True	True	True
GGTCCGTAGGAACGGT-1	True	True	True
AGCAGGTAGTCTTGAA-1	True	True	True
AGTAACCTCCATCAGG-1	True	True	True
ACCTTCATCCCTCGCA-1	True	True	True
ATTAGCGGTTGTCATC-1	True	True	True
GCCTGACAGCCGCTTT-1	True	True	True
GGATGAATCCCATAGG-1	True	True	True
TGTTTGTTCTTAGTCT-1	True	True	True
TATAGGTGTGCCGCAA-1	True	True	True
TCAGGTTAGACACTTA-1	True	True	True
CTTGACGAGTGAGGTA-1	True	True	True
TACTAAGTCTGTGAGT-1	True	True	True
TACTAAGTCCGGCTAA-1	True	True	True
TTTCTCACATAGCGAG-1	True	True	True
ACTCACCTCATTACAG-1	False	True	True
GGACCGAAGTTAGGCT-1	True	True	True
AATCTTGAGATAAAGC-1	True	True	True
TCCAGCAAGTCAGTAC-1	True	True	True
ACACTAGGTCCTAACT-1	True	True	True
GAACCAGCAGTACCGT-1	True	True	True
GGTGTCCAGGCTAAGA-1	True	True	True
ACCTTCATCCCGCCTA-1	True	True	True
ATATGCTCAGGCAAGC-1	True	True	True
CGTTATCGTTTGAGCA-1	True	True	True
AGCCTCCGTCCGCTGT-1	False	True	True
CAAGACAAGGTCCTAG-1	True	True	True
TGATCGAGTAATAGCT-1	True	True	True
ACTTGCACAGTCTAAT-1	True	True	True
AAGACATAGGATTGAG-1	True	True	True
ACAACAACAAAGCTCC-1	False	True	True
CGCGGATTCAGCAAAG-1	True	True	True
CTGGTCAAGGACACTT-1	True	True	True
ACGTCCTTCTAAGGTC-1	True	True	True
CTGTAACAGTCACCAG-1	True	True	True
ACGAACAAGGTATTGC-1	True	True	True
TAAGGCTTCAGGAAGC-1	True	True	True
CTAATTGAGTAATCCA-1	True	True	True
AGGAAACGTAATGGAA-1	False	False	True
CAGCAAGCAAAGCGGC-1	True	True	True
TCGTTAAAGTTATGGC-1	True	True	True
AAAGGACGTTGAAGCC-1	True	True	True
TAGTACGGTTAGGTTG-1	True	True	True
CCTGATGAGGTGTTAC-1	True	True	True
ACGTACCCACCTAATG-1	True	True	True
CCTTAGTGTGCATCGG-1	False	True	True
CTCATTTAGTCACTCC-1	True	True	True
TACCGAAGTTCGCTCA-1	True	True	True
GGCCTTCGTTAAGCTG-1	True	True	True
CTACGAAGTTAATGAC-1	True	True	True
TTGTCCGGTTGGGTTA-1	False	False	True
TCTGGCTTCAGCACCA-1	True	True	True
CCATCACTCTAAGTCA-1	False	True	True
CCCTCATAGGAGCACG-1	True	True	True
TGTGCGCAGCTGCACA-1	True	True	True
ACCGGTTCAAAGCGCA-1	False	True	True
TAACCAGGTTGTTCAC-1	True	True	True
AGGTCATTCAATAGCC-1	True	True	True
CCATAAGGTTGCAATG-1	True	True	True
CTTTGTCCAGCTCATA-1	True	True	True
TGCTTCATCGATATTG-1	True	True	True
TCCTCACAGGTGAAGC-1	True	True	True
CATGAGGCATGATTGT-1	False	False	True
TAGCAGGCACACAATT-1	True	True	True
CAATCCTGTTAGTGAT-1	True	True	True
TTTGTTGGTGATCAGC-1	True	True	True
GCAACAGCACCTGGTG-1	True	True	True
GCTTAAATCCATTACT-1	True	True	True
GCAAACAAGGGACTAA-1	True	True	True
ATCCTGACACTTCATC-1	True	True	True
TTCGTGCTCAATTGGC-1	True	True	True
CCAGGAACAGTTAGCC-1	True	True	True
GGGCAATAGTAGCGGG-1	True	True	True
GCACTAAGTCTTACTA-1	True	True	True
TCCTTGCAGTTTGTCT-1	True	True	True
TCGTTATTCGGTTAGT-1	True	True	True
GATTGCAGTGTCCTGC-1	True	False	True
CGCTGTGCAGCACCAT-1	True	True	True
CGGACAACACTGACCG-1	True	True	True
GCTTTACGTCCTCCAA-1	False	False	True
AGTTTGCAGGATAAAC-1	True	True	True
ATGAAGTAGGCCAATT-1	True	True	True
AAGGTGCAGTAGCCAT-1	True	True	True
TTTCAGTTCTAAGTGC-1	True	True	True
GCAGGATAGTAGCGCC-1	True	True	True
AAGCAAGTCGCAGGCT-1	True	True	True
AAGCGAATCTAAGGTC-1	False	True	True
GGTGCTGGTCATGAGC-1	True	True	True
TCCATAAAGGTTAGAG-1	True	True	True
GCCTCAAAGAGGAGGA-1	True	True	True
GTATTCAAGCCGCAAC-1	True	True	True
TGCGCAGGTCGCGCAA-1	True	True	True
AAAGCCGCAATAATCC-1	True	True	True
TCGGTTTGTCGACTAA-1	False	True	True
CTGCTACTCGCCTGTT-1	True	True	True
TGGAACAAGGGCTTAT-1	True	True	True
GTATTGTCATGAATCT-1	True	True	True
ATTTGCGCAGAACCGA-1	True	True	True
ACTTATCTCGTCATTT-1	False	True	True
CTCGCTCCAACTAGCC-1	True	True	True
GTGCACGGTGGTTATG-1	True	True	True
TTAGCAATCCCGCAAA-1	True	True	True
TGAGTTTCAAGCGAGC-1	True	True	True
GATAGACCACCATATG-1	True	True	True
ACGCACGGTTACTAGG-1	True	True	True
CCTCCTCTCGTGCCTT-1	True	True	True
CTGCTACTCGGTTTCC-1	True	True	True
ATTGGTTCAATTGACT-1	True	True	True
TTCATCCCACAGAACG-1	True	True	True
TGGACAAAGCACTAGT-1	True	True	True
AATTGTGTCACAGCCA-1	True	True	True
CATTATCTCCAAATCA-1	True	True	True
CTTGAACAGAAACTGG-1	True	True	True
TTCCTTCTCCTCAGTC-1	True	True	True
CAGGACCTCTTACTCG-1	True	True	True
CTCCTAATCTCCATAT-1	True	True	True
ATTACCCGTGATTTGG-1	True	True	True
CGAAGTAAGTAAGAAC-1	True	True	True
TATTCGTTCGCTAAAC-1	True	True	True
AGGATTGAGACTTACA-1	False	True	True
GAGGCTTGTAATTAGC-1	True	True	True
GTCCTAGAGGGTTATC-1	False	True	True
GGATGGCCACTGACCG-1	True	True	True
ACCAAACTCCTCCATA-1	True	True	True
GATGGCTGTGCTCCGT-1	True	True	True
TATGGTCAGTTAGTTG-1	True	True	True
TGAGCAAAGGCTAAGA-1	True	True	True
CCCGCTTCAAGGTCGA-1	False	True	True
TCGACAAGTACTGAAT-1	True	True	True
GTGAACAAGATGCCTG-1	True	True	True
AAGACCAAGTTGCCTC-1	False	True	True
CGCGGATTCCCTCACG-1	True	True	True
CACAGGGAGCGAGGTG-1	True	True	True
CACATTAAGCCAAATC-1	True	True	True
CCATTGTGTTAAGCCA-1	True	True	True
TTGGATTCATGTCAGC-1	True	True	True
TACGGATTCATTACTC-1	False	True	True
CACATACAGGTAGCTT-1	True	True	True
CGCCTGTGTGATCAGC-1	True	True	True
CCATAGCCAGCCAGAA-1	True	True	True
GTTGGCGGTTAAATGC-1	True	True	True
CAATCGCCAGTAGCCT-1	True	True	True
ATACCTGCATAAGCAA-1	True	True	True
ACTAACGGTTTGTCTA-1	True	True	True
GCGGAACCATATAACC-1	True	True	True
TGGTAAACACCAAAGG-1	True	True	True
GATGCTTAGTTATTCC-1	True	True	True
CAGGTTTAGACAACAG-1	True	True	True
CCATAAGGTGTGTCCC-1	True	True	True
TGAGGGAGTATCTGGA-1	False	True	True
CCGATGCAGGCTGTGC-1	True	True	True
GGCTTCAAGTAGGATG-1	True	True	True
CGGTTATAGTGAACCT-1	True	True	True
GCGCAAACACATGCTA-1	True	True	True
CGTTAGTAGCTTATGA-1	True	True	True
GCCATGATCAGGCCTA-1	True	True	True
CCATTGTGTGGTTCTT-1	True	True	True
CGAGTCGGTCCGCTGT-1	True	True	True
CCTACTGGTCACAGCG-1	True	True	True
ACCATAATCCGTCCAT-1	False	True	True
CTTGAATCATGGAGGC-1	True	True	True
TGTTCCTCATATAACC-1	True	True	True
TACCAAATCCGCATGA-1	True	True	True
AATCTTGAGCATCCAG-1	True	True	True
TCGCGCACAATGCGCT-1	True	True	True
ATTTAGCCATGTCGCG-1	True	True	True
CTTGGACCACTTCATC-1	True	True	True
ATTGGCTAGAGAAGGG-1	True	False	True
CTCCAAACACCTGGTG-1	True	True	True
AATTGACGTCAGGAAG-1	True	True	True
AATCCATCAACAACAA-1	True	True	True
GCTAAGTTCTGGCATG-1	True	True	True
ACGCTTGAGTTAACCA-1	True	True	True
ATCGAGGCATGCTCCC-1	True	True	True
CAATGTGGTTTATTCG-1	True	True	True
CATGCAAGTATTTGCC-1	True	True	True
TGCTTGCTCGATTTAG-1	True	True	True
TTGACTAAGGGATGAC-1	True	True	True
TCCTGGTTCCTGATGG-1	False	True	True
TATCCAGCAACACTTG-1	True	True	True
CGCCAAATCATTACTC-1	True	True	True
GCCTTTGGTTTCGCGC-1	True	True	True
GACTTAGGTTAGGATT-1	True	True	True
ACCTTCATCGAAGCGG-1	False	True	True
CGTATTGCAGTAAAGC-1	False	True	True
AACCTTGCAACCTGGT-1	True	True	True
ATTCACTTCACTTTAC-1	True	True	True
TCAGGTTAGATAACCC-1	True	True	True
CGTGAGGAGCACTAGT-1	True	True	True
CCTAAGCCAATCCTAG-1	False	True	True
TGTGGCGGTCCGGTTC-1	True	True	True
GAAACTGAGACAGGTA-1	True	True	True
ATAAGCCTCACGAATC-1	True	True	True
GGATTGCGTGGGTGAA-1	False	True	True
AGCCGGTTCCGCCTCA-1	False	True	True
CTACAACAGTCAGGCC-1	True	True	True
CAGCATGTCAAGACTC-1	True	True	True
GACCTGCAGCACGTTG-1	True	True	True
GGGCCTAGTCACAGAC-1	False	True	True
GAGTTACTCGAGGAGT-1	True	True	True
CAATGTGGTTAGCCAA-1	True	True	True
ATTAGTCCACCTACGG-1	True	True	True
GTGCTTACAATACTGT-1	True	True	True
GGTGTCCAGTCAGGCC-1	True	True	True
GCAATCTAGGATCACT-1	True	True	True
GTAGTTATCGCTAAAC-1	True	True	True
GGCTATGTCATTTAGG-1	True	True	True
ATGGCCGGTCGCGCAA-1	True	True	True
TCGTTAAAGGCGAATA-1	True	True	True
TAATGGACATAGCGGA-1	True	True	True
GAAGGCCCACTAAATC-1	True	True	True
CATTGTAAGTTAGGCT-1	True	True	True
AGCCTAAGTTTATTCG-1	True	True	True
TCTCCTCGTTAGGACC-1	True	True	True
TTTGAGTCAGTAATAG-1	True	True	True
GGTCTTGAGACAGGTA-1	True	True	True
GCTGGATGTTTACGTC-1	True	True	True
TGGCGGTTCGTTAGCG-1	True	True	True
AAGTTACGTTCACCCA-1	True	True	True
AGCGGACCAATGCGCT-1	True	True	True
CATTATCTCCAGCACA-1	True	True	True
GCGGGTTTCTTTAAGG-1	True	True	True
TGCACTTGTCATTAGG-1	False	True	True
TATTGACCAGGAACCA-1	True	True	True
GACATTATCATTGTTC-1	False	True	True
ATCCTTAGTTAGGCGT-1	True	True	True
CTAGTGAGTTTGTCTA-1	True	True	True
AGAAGGTGTTAAGGTT-1	True	True	True
ACTTGCACACCCACAG-1	True	True	True
GTCAAACTCTTTGACT-1	True	True	True
TCAGTAGGTTGACTTC-1	True	True	True
CGTGTTACAGGCTTGT-1	True	True	True
TGGTCATAGTAAGGGC-1	True	True	True
CCATAAATCTGTGCAG-1	True	True	True
CGATTCCTCATAGCCG-1	True	True	True
ATTCCTCCATGTTGTG-1	True	True	True
CTCCATCAGCGTGCAC-1	False	False	True
CCGCAAGGTAACTACG-1	True	True	True
TATGACTCACAACAGG-1	True	True	True
TCTAACCGTGTTTCAC-1	True	True	True
CCGCTAGCATGACTAT-1	True	True	True
ATTTGTGAGTAGCGGG-1	True	True	True
TTCCACGGTTAGTTGG-1	True	True	True
TTGAGGCGTTTAAAGC-1	True	True	True
ACTCAGTAGTAGCCAT-1	True	True	True
AGAACAAGTTTGCGAA-1	True	True	True
CATTCATTCATTAGGC-1	True	True	True
TTGGAGGCAGGTTAAA-1	True	True	True
GGCTGAGAGCACTAGT-1	True	True	True
AGCTGCTCAGGCTTGT-1	True	True	True
TCCGGTTTCATCCACC-1	True	True	True
TCAGTAATCCACAATA-1	False	True	True
TAGCCGGGTGAGGTAG-1	True	True	True
AGCGATTTCATTACTC-1	True	True	True
CAAATCATCATAGCCG-1	False	False	True
AGCTCATAGTTCCTCA-1	True	True	True
CGCCAAATCAGTATTG-1	True	True	True
CGCATATAGCCACATG-1	True	True	True
TGCACTTGTTGTTGTC-1	True	True	True
ACACCTTGTGATCAGC-1	True	True	True
CTGTATTTCGCAGGCT-1	True	True	True
GTAGGCGAGCTGTACG-1	True	True	True
TTCCTTCTCCTACCTA-1	True	True	True
AGTGAGTCAGACAAAC-1	True	True	True
TGCTTCCAGCTTTGGG-1	True	True	True
TTTAGCTTCGAAGTAG-1	True	True	True
GGTTTCTGTCGCATAA-1	False	True	True
CTTTGGGAGTTAGGCT-1	True	True	True
TCTCACCAGCCGCTTT-1	True	False	True
GGACGGATCTGTGAGT-1	True	True	True
GCGCAATGTAATGACT-1	True	True	True
GTTTCTAGTTCATCTA-1	True	True	True
TATGACATCCGCACAA-1	True	True	True
AGTTACTCACAACCTA-1	False	True	True
AGTGATGAGGTATTGC-1	False	True	True
CAAACCGTCAATCTCT-1	True	True	True
ATCGCTTGTTGTTGTC-1	True	True	True
ACCTCACTCCATTACT-1	True	True	True
ACTTGTAAGAATCGCT-1	True	True	True
GAGGTTAAGCTCAAAC-1	True	True	True
TCGCGCACATATTGAC-1	True	True	True
GGCAGGATCCTCATCA-1	True	True	True
CAGCCAATCCGGCTAA-1	True	True	True
CCCTAATGTCCTTTAA-1	True	True	True
GAAGCTAAGTAAGAAC-1	True	True	True
CTTTGAGCAATCCTGA-1	True	True	True
ACAGGCTGTAAAGCGG-1	True	True	True
AAGCAAGTCACAAGCT-1	False	True	True
GCTGTAAGTTAGGTTG-1	True	True	True
AACATCATCCTCATGC-1	True	True	True
GTCTAATCATGGTTAT-1	True	True	True
CACAAGCGTTCCTCCT-1	True	True	True
GCAGGCTTCCCTGACT-1	True	True	True
GCCTTAACAAGGTACG-1	True	True	True
GGACGGATCGGTAACT-1	True	True	True
GGTCTTGAGGATGATG-1	False	True	True
CCATAAATCCTGGTCT-1	True	True	True
GCTCAACCACTTAACG-1	True	True	True
TTTCTTGCAGTTTCTC-1	False	True	True
AGAGAAGCAGTCTAGC-1	True	True	True
ATCACACAGTGCTGTG-1	True	True	True
GCCACAATCATTAGCA-1	True	True	True
GACTTAGGTTAAATGC-1	True	True	True
GCTAAGTTCACTCGCT-1	True	True	True
CAAACGCGTGCTCCGT-1	True	True	True
CATAGGCGTCCGCTGT-1	True	True	True
TCGTAATCAGGGAGCT-1	True	True	True
ATGGTGCGTTAGAGCC-1	False	True	True
GCTGGATGTAATCGGC-1	False	False	True
AGTAAGTAGTTGTCAA-1	True	True	True
CTATGACAGCTATATG-1	True	True	True
ATGCTTAAGGTAGCTT-1	True	True	True
TGGCTATAGCACTAGT-1	True	True	True
CGTGCACAGTGATTCA-1	True	True	True
CATAAGCTCCAATTAG-1	True	True	True
AGTAATGCAGTTTCTC-1	True	True	True
GGGATTAAGTGTGATC-1	True	True	True
GCTAGCCAGGACCTCA-1	True	True	True
CCCTAATGTGTTTGTC-1	True	True	True
AATATCCCAGCCGCTA-1	True	True	True
TGGTTCTGTCACAAAT-1	True	True	True
TTTAACGAGCGAGCGA-1	True	True	True
CGCTATGAGCACAGAA-1	False	False	True
CATCCTCAGGAGTCGG-1	True	True	True
AGGAACGGTCATTAGG-1	False	False	True
TACCGAAGTTACATCC-1	True	True	True
AGTCGCATCATTACGA-1	True	True	True
ACTTATGAGCATTATG-1	True	True	True
TCTAGCACAATACTGT-1	True	True	True
CGAGGTGAGCTTATGA-1	True	True	True
GTGTAACTCCTCATGC-1	True	True	True
TTGTCCGGTTCCATTA-1	False	True	True
CTCTAAGCATGCTTAG-1	True	True	True
CTAATCTTCGAGGAGT-1	False	True	True
ATGCCTGAGCTTTGTT-1	True	True	True
TCAGCGATCAAGGACA-1	True	True	True
GTGCAAGCATAGCTTG-1	True	True	True
TGGAACAAGCGCAATT-1	True	True	True
AAGCGCTGTGTTTGTC-1	True	True	True
TTTGTCTAGGACAACA-1	True	True	True
TAGGCTAGTCTTACTA-1	True	True	True
GCTATAGGTGTTCCCA-1	False	True	True
CACTAGCCACCAACCG-1	True	True	True
ACACGGACAGCAACCT-1	True	True	True
GCTTAACAGGTTTGAC-1	True	True	True
GCAGGATAGCTCCCTG-1	True	True	True
TAAGGACCATGAAGTA-1	True	True	True
ACACGGACATTGCGAC-1	True	True	True
CCGTTATGTTACCTGT-1	True	True	True
TACCGCAAGTCTGGGC-1	True	True	True
GTTAGACTCGAAGTAG-1	True	True	True
ATCCAACAGCTTGCTC-1	True	True	True
ATTTGCGCACAAAGAC-1	True	True	True
TATCGAGGTACCGTTT-1	True	True	True
ATTGAAGCAGGACCAA-1	True	True	True
TACCAAATCCTTAGTT-1	True	True	True
GATCAGTTCACGCATG-1	True	True	True
ATTTGTGAGGACCTTG-1	True	True	True
CTAGTGAGTTACTTGC-1	False	True	True
CATTGTAAGTTCCTCA-1	True	True	True
GATGCAGCAAGCTACC-1	True	True	True
TGTCAGTAGTTCCTCA-1	True	True	True
TGTCAGTAGGAGGACT-1	True	True	True
GAGGTTAAGTCTGGGC-1	True	True	True
TCGGTTACATAAGCAA-1	True	True	True
TGTCCTGGTTAGCGTA-1	True	True	True
CTCTAAGCATAAGTTC-1	True	True	True
TTGCAAGGTAACTACG-1	True	False	True
CACATAATCCTCATCA-1	True	True	True
ATTGTCCGTGAGAAAC-1	True	True	True
ATTTGCGCAGAAATGC-1	True	True	True
GGCCTTAAGACACCGC-1	True	True	True
GGGTATTTCGACAAAG-1	True	True	True
ATCACTAAGCATGCAT-1	True	True	True
AGGATCCGTTTAGCTC-1	False	True	True
AGCCTAGTCGGTCATG-1	True	True	True
CGATCCTTCGCTATAA-1	True	True	True
GAACTTATCCTAATTC-1	True	True	True
AAAGGCTCATCCAGGT-1	True	True	True
TTGTTGCGTTCAAGAT-1	True	True	True
ATCACCCTCTTTGTAC-1	True	True	True
CGAACAAAGGACAACA-1	True	True	True
AAAGCACCACAGGAAT-1	True	True	True
TTCGTGCTCGAAGCGG-1	False	True	True
GGTACAAAGGACCAGG-1	False	True	True
TACGTACAGTTTGTCT-1	True	True	True
AGAATCTGTTGTGATG-1	True	True	True
CGATTCCTCATTTAGG-1	False	True	True
GCTAAGCGTTACGCGG-1	True	True	True
CATCATAAGTTGTCAA-1	False	True	True
TAGACCAGTAACCAGC-1	True	True	True
AAACGGATCCCTGACT-1	True	True	True
GATGACTTCTTACTCG-1	True	True	True
GTAGGAGGTCATTAGG-1	True	True	True
ACAGGAATCCTGATGG-1	False	True	True
CTTAAGATCTTGATGA-1	True	True	True
GACATTATCTAGCGTG-1	False	True	True
GTCAATATCACGCATG-1	True	True	True
TCCTTTACACAACCTA-1	True	True	True
CGCCACACATCCGTAA-1	True	True	True
CGCTTACTCCTTAATC-1	True	True	True
CTATGACAGAGGCTAA-1	False	True	True
GATCACTAGCCTCTCG-1	True	True	True
AGATGAAGTCATTACC-1	True	True	True
CCCAAACCACCTCGCT-1	True	True	True
ACGAATCTCCTCAGTC-1	True	True	True
GTGTTCCTCAAACCTA-1	True	True	True
ATCCGTGAGGTTAGAG-1	True	True	True
CGCTAATAGCTGCACA-1	True	True	True
GCATTGCCAACCTAAT-1	True	True	True
GTATGTGGTAATAACC-1	False	False	False
CTGCAATAGGTAGCTT-1	True	True	True
TACAATGTCCAAGTGT-1	True	True	True
CGATATTCAATAACCT-1	True	True	True
AACAGGATCCCATAGG-1	True	True	True
TGAGGAGGTTGGCCGA-1	True	True	True
CACCTCAGTCAAGTGC-1	True	True	True
AATGCATGTGAGGTGA-1	True	True	True
TGCATCCTCACGAATC-1	True	True	True
CATCACACATGTCGCG-1	True	True	True
CCTTCAGGTTACGCGG-1	True	True	True
CTTCACTCAGCAACCT-1	True	True	True
CCGTTACTCGAGGAGT-1	True	True	True
TGAAGCAAGACTTACA-1	True	True	True
CAGCCTTTCCCGCCTA-1	True	True	True
TTTAACGAGTTTGAGC-1	True	True	True
TTTGCGACACTAAGCC-1	True	True	True
TTAGGCGTCCTAGTAA-1	True	False	True
CTGGTCAAGGGTGAGT-1	True	True	True
TGCAATATCATTGCAA-1	True	True	True
GATAACGAGTTTCCTG-1	True	True	True
CATAGCTAGCATGCAT-1	True	True	True
GTGTCCAAGTGTGATC-1	True	True	True
ACTAACGGTGAACAAA-1	True	True	True
TTTGGCTGTTGGTTCT-1	True	True	True
CAAGACAAGGCTACTG-1	True	True	True
ACCGCAATCTTAGTCT-1	True	True	True
TGTCCTGGTCCCGGAA-1	True	True	True
GTAAAGCCACTCGCTC-1	True	True	True
GTCGAGGAGGAGGGTT-1	True	True	True
CACTAAGGTTAGCATG-1	True	True	True
AGTTGTCAGGTCTTGG-1	False	True	True
TCGGTAAGTGTTTGCT-1	True	True	True
CACCTCAGTTCAAGAT-1	True	True	True
ACCATTAAGCTGGAAA-1	True	True	True
CCACAGGGTTGTTGCT-1	True	True	True
GTGCGCAGTAGCCATA-1	True	True	True
AGTAATCGTACGGTAC-1	True	True	True
CCCGTAAAGGACACTT-1	True	True	True
TACAACATCAATGTCA-1	True	True	True
GTATTGTCAGGCGATA-1	True	True	True
CGGTTATAGCCGCAGT-1	True	True	True
GGAACGGTCAAGCGCC-1	True	True	True
CGAGGCAAGCGGGCAA-1	False	True	True
TTAACTGAGGCGCATC-1	True	True	True
CTTGAATCACAAGCCT-1	True	True	True
GTCGAAGCACTTAGGC-1	False	True	True
AATTTCCTCGTTACAA-1	True	True	True
GTTTAGCAGCTTCTCA-1	True	True	True
TTAGAAGCAGGAACAT-1	True	True	True
TAGTGTGGTAGCCTCC-1	True	True	True
TTTGTGTTCCTGGTGA-1	True	False	True
GGATACTTCGGTAACT-1	True	True	True
ATCAAGCTCCTACCTA-1	True	True	True
ATGCAGGCAAAGCCTC-1	False	True	True
CAAGGCTGTGTGTCCC-1	True	True	True
CAGGGTGAGCTTAGTA-1	True	True	True
TACTGAGGTGCACGCA-1	True	True	True
AGTAACCTCCAGGAAA-1	True	True	True
TGTGTGAGTAGCCATA-1	True	True	True
ATGAAGCCAAACTGTT-1	True	True	True
GTATTGATCACGCATG-1	True	True	True
AGATGCTTCATAGCCG-1	True	True	True
CTATTCAGTGTAACCA-1	True	True	True
GGATATTGTGGTTCTT-1	True	True	True
CCAACCAAGTATTGGC-1	True	True	True
TCATTGCGTCATCATC-1	True	True	True
GGATGGCCAGCATGAG-1	True	True	True
CGCAATTAGGGTGGAT-1	True	True	True
GGAACAATCAGGTTTA-1	False	True	True
ACGCAAGCACCCACCT-1	True	True	True
CTCATTTAGTAGCGGG-1	True	True	True
TAGTCAATCAGGCCTA-1	False	False	False
AGGCGGATCTGTAAGC-1	False	True	True
TATATCCTCCACCCTG-1	True	True	True
TGCATTAAGGAAACTG-1	False	True	True
TTAGGCCCATTCCTGT-1	True	True	True
TAGCCTCTCCCGTTTA-1	True	True	True
ATGCAGGCAGCCTGCA-1	True	True	True
GAGGTTAAGGATTTGC-1	True	True	True
CTCTGTTCAGGTTACC-1	True	False	True
ACGATTCAGTCCTTCA-1	True	True	True
GCCCGTTGTTAGACCA-1	True	True	True
TGATCGAGTTGTTGCT-1	True	True	True
TTTCGTCCATCCTAGA-1	False	True	True
TTTGTCCCAATCCCTT-1	True	True	True
GGAGGTTAGCCTCTCG-1	True	True	True
CACATTAAGGCCAATT-1	True	True	True
TCACTGACATGCAACC-1	True	True	True
CAATCCTGTACCCACC-1	True	True	True
TGACCAAGTCCAAGAC-1	False	True	True
CTCCGTCCAGCCAGAA-1	True	True	True
GGTAACTTCCGTGACA-1	True	True	True
GCAATATGTGATCATG-1	False	False	True
GCATTAGGTTACCGGG-1	False	True	True
ATAACGACAATAACCT-1	True	True	True
GTCATGAGTAGGTTAT-1	True	True	True
TGATTGCAGCTAATTG-1	True	True	True
GAGAACCAGCCGCAGT-1	True	True	True
TAAGTGCTCTTAGCGG-1	True	True	True
TCTTGACGTAACCAGC-1	True	True	True
ACCTTGCTCGGTCAAT-1	True	True	True
GCTAAGTTCACTTCAT-1	True	True	True
TCTACTAGTAGCTAGC-1	True	True	True
TTTACGAAGGTCCTGA-1	True	True	True
CGATATTCATTATGCG-1	True	True	True
TATGGTCAGATGGACA-1	True	True	True
CTTTCTTGTGATCAGC-1	True	True	True
ATGTAAGCAATGCGCT-1	True	True	True
CCAACCCGTTCCGGGA-1	True	True	True
TCGGTTTGTTAGTTGG-1	True	True	True
TTCACTGTCAAACACC-1	True	True	True
TCAGTAGGTGCATCGG-1	True	True	True
GTTCCTGGTAATGACT-1	True	True	True
ACCAGGACAAACGCGA-1	True	True	True
ACCTTCATCACATTGA-1	True	True	True
TATGGCCCATCCAGGT-1	True	True	True
GTTGTGAGTTAGACCA-1	True	True	True
TAGTTGTCAAGGTGCA-1	False	True	True
CTACGAAGTGAGCAAG-1	True	True	True
TCCTGTTCAAGGTAAC-1	True	True	True
AATCCTAAGATAAAGC-1	True	True	True
TACTCAAAGTTGTCTT-1	True	True	True
AACAGATAGTCACCAG-1	True	True	True
GTGCGGTTCCGTCCAT-1	False	True	True
GGGCCTAGTGTTGCTT-1	True	True	True
TGAGGAGGTTAACGGC-1	True	True	True
CCTGCTCCACATTGCA-1	True	True	True
TACGCTTGTCTTACTA-1	False	True	True
AGCTTGGTCATTGCAA-1	True	True	True
TAACCGGTCTTGAGCG-1	True	True	True
CGTGACATCGTTAGCG-1	True	True	True
GACACCGGTATTGTGG-1	False	True	True
GCAGCCAGTTTCGCCA-1	True	True	True
GATTAAGCACTTCATC-1	True	True	True
GATGAGGGTTAGGCTA-1	False	True	True
TGGTAAACAAACTGTT-1	True	True	True
ACAACAACACCTAATG-1	True	True	True
GCTTTATTCATGGCCA-1	False	True	True
GCTCAACCAGCACGTT-1	True	False	True
CGCACACAGTCATCCC-1	True	True	True
AATTGCTCAACAGCCT-1	True	True	True
CCCTCACCACCTGCTC-1	True	True	True
TTACGTTTCCAACTGG-1	True	True	True
TCAAGCTAGAAACTGG-1	True	True	True
CTTAACAAGTTTGCGG-1	True	True	True
GATTATGTCCAGGGAG-1	True	True	True
CCATCACTCTGTTCAT-1	True	True	True
TTCAACCGTTGTAACG-1	True	True	True
TCGCTAACATAATCAC-1	True	True	True
TCATCCATCACAGCGC-1	True	True	True
AACATAGCAATGAATG-1	True	True	True
CGGCCATAGGCATGAA-1	True	True	True
CGCGATTCACCGGTAT-1	True	True	True
GAACCTGTCAATTACG-1	False	True	True
CACATTAAGCACAGCC-1	True	True	True
AACGCTAGTGAGGTAG-1	True	True	True
GATGACTTCAGTGAAG-1	False	False	True
TTCGCAACAAGGATTA-1	False	True	True
AGGAAACGTGCGCGTA-1	True	True	True
GCAAGTCGTTTATTCG-1	True	True	True
CTAACCACAGCATGGA-1	True	True	True
GCTCTGGCAGTTAAAG-1	True	True	True
AATTACCCACCAGCAT-1	True	True	True
TGAAACTGTCAAGTAT-1	True	True	True
TGTTATGAGCACTTGG-1	True	True	True
GCCTCAAAGGAATAAC-1	True	True	True
GGAACTAAGGCTAGAA-1	True	True	True
GTAGCCATCTGCAAGT-1	False	False	False
GAGGCAAGTCCAAGAC-1	True	True	True
GTAAGGTCAGCACGAA-1	True	True	True
CCTGGATCATTAGCCA-1	True	True	True
AGCAAGGGTACTGAAT-1	True	True	True
AAAGGAGCACCGTTCC-1	True	True	True
GATTAGTGTTTACGTC-1	True	True	True
AATTAGCGTGGTTCTT-1	True	True	True
CTATGGCCACCACAAC-1	True	True	True
TGGTTGAGTTCCTGAT-1	False	False	True
GTCTTGCTCTAAGTGC-1	True	True	True
AGGGCTACAGCCAGAA-1	True	False	True
TCAAGGTTCCAAGTTA-1	False	True	True
CACATAATCTGGCATG-1	True	True	True
TGGGCATGTGTTGTGA-1	True	True	True
ACCTGGATCCATAAGC-1	True	True	True
GTTACAGGTTAACGAT-1	True	True	True
TACGGTTAGTGAACGA-1	True	True	True
TCAGTGAGTAGTAAGA-1	True	True	True
CTTTGTCCAGTTTGTG-1	True	True	True
GTGTTACAGATGCCTG-1	True	True	True
CCTTAACGTCAGTAAT-1	True	True	True
ATCCACCTCCGTTATT-1	True	True	True
AGGCAGGTCAGGATGA-1	False	True	True
CACGCTAAGCCTAATA-1	True	True	True
ATGGCTTAGTATTGCA-1	True	True	True
AGTGCGGAGCCTAATA-1	True	True	True
CTTGAACAGAAGGTGC-1	True	True	True
ACGTACCCATAGACCC-1	True	True	True
TTATGACCAGTTATGT-1	True	True	True
TAGGAACCATTATGCG-1	True	True	True
CCATTGTGTTCCGCAC-1	True	True	True
GTAAGCTTCATAAGCC-1	True	True	True
CGTTAGTAGCCGCAGT-1	True	True	True
AGAATCGAGTGAGCGG-1	True	True	True
GAAGGAACAGGTTACC-1	True	True	True
ATGCAGGCAATAATGG-1	True	True	True
GGTCAGGAGTAGCGCC-1	True	True	True
GGAACCTGTGCGCAAT-1	True	True	True
ATAACGACAAGGTATA-1	False	True	True
AACCTTAAGCTCAAAC-1	True	True	True
CTCCTGAGTTGAATCG-1	True	True	True
GGTAATTGTTGCTGGG-1	True	True	True
TGCACCTTCCTTAGTT-1	True	True	True
TCCGCCATCAAGCGCC-1	True	True	True
GTGTGTTAGCAAGGTA-1	True	True	True
AGCAATTGTCTTGCAT-1	False	True	True
TTCATTCAGCCACATG-1	False	False	True
AACGACAAGGATCCGC-1	True	True	True
GGCTCAATCCCGTTGT-1	True	True	True
GGGTTTGTCATGTTTC-1	True	True	True
TTCATTCAGTTATGTG-1	True	True	True
AGGAAACGTGTTGCTT-1	True	True	True
TTCAACCGTATTGAGT-1	True	True	True
AACAGCAAGGGTGGAT-1	True	True	True
ATCATCAAGCCTGACA-1	True	True	True
ACGTTACAGTTCCTCA-1	True	True	True
GGCATTAGTAACCACA-1	True	True	True
GTTAAGTGTTAGGTTG-1	True	True	True
AACCTCCTCCTCCCTC-1	True	True	True
TCGGTTCTCAATTGGC-1	True	True	True
CGTATTGCAAGGAATC-1	True	True	True
CCCTCACCAATCCTGA-1	False	True	True
GATCACTAGTCAGGCC-1	True	True	True
TGTTAGCAGGCGCACT-1	True	True	True
AACAAGCCAGCCTTGG-1	False	False	True
CATGCGGGTCCGCTGT-1	True	True	True
TGCTTTAGTAGCTGCG-1	True	True	True
GAAGTCAAGGGCCATC-1	True	True	True
GCCTGACAGGTGCGGA-1	False	True	True
ACGATTCAGGAACGGT-1	True	True	True
CGCATTACATGGCCTG-1	True	True	True
CGGTTTCTCCATAATG-1	False	False	True
TATCACAAGCTGGAAA-1	True	True	True
GCAATGTTCTAACCAA-1	True	False	True
AGCACTAGTGGTTCTT-1	True	True	True
TGTATCCGTTTCGCGC-1	True	True	True
GGCTATGTCTCAATAG-1	True	True	True
TACAATGTCGTTTCCA-1	True	True	True
CCTACTGGTTGTAAAC-1	True	True	True
CACATAATCAATTACG-1	False	False	True
TAATCCGCACAGGGAC-1	True	True	True
TAGACCAGTAGGATTT-1	True	True	True
CGCACCACAGGATTAA-1	True	True	True
GTTCCTGGTTAGCATG-1	False	True	True
TCAAGTATCTTGAGGT-1	True	True	True
TACCTCATCCAAGTGT-1	True	True	True
CTACCGGCATTAAGCT-1	True	False	True
CTCCTGAGTTTGTGGA-1	True	True	True
GAGCTTAGTGTTGTAG-1	True	True	True
TAGCTTAAGGCACAGG-1	True	True	True
GAGGTACAGGTGCGGA-1	True	True	True
ACTCACTGTTAGAGGG-1	True	True	True
TTCAACCGTAGGTGTC-1	False	True	True
CGTACGGGTCATGCCC-1	True	True	True
TCTAACTTCCCGTTTA-1	False	True	True
GCTGTAAGTTTATCGC-1	True	True	True
CGACCTGCAGCATGAG-1	True	True	True
GGTTACTAGGCGCATC-1	True	True	True
AGCAATTGTATTCGCT-1	True	True	True
ACCACACCAGGCGAGT-1	True	True	True
GAGGTTAAGCTATGAC-1	True	True	True
GCACCTAAGCTATTAG-1	True	True	True
GCACCTAAGCAGGCCT-1	True	True	True
TCGTAATCACTTCACT-1	True	True	True
GCCACAATCCATAATG-1	True	True	True
TTTGTGGCAAGGTAAC-1	True	True	True
GATTAAGCAATGAATG-1	True	True	True
AGTGCACGTGTTCCCA-1	False	True	True
AGAACCAAGTCAGGCC-1	True	True	True
CTTGTAAAGCTCAATA-1	True	True	True
CAGGCTATCACCTGCT-1	True	False	True
AAAGGTTAGGACTAAG-1	False	False	True
GGCCTTAAGCCTGTTC-1	True	True	True
ACGCCACAGTTGGCCA-1	True	True	True
CCTGCTCCACTTAGGC-1	True	True	True
TGAGAACCATTATGCG-1	True	True	True
CGTTTGGAGCGGGCAA-1	True	True	True
GATCCGTCAACGTGCT-1	True	True	True
GACCTAAGTTTCCACG-1	True	True	True
TGAACAACAACCTAAT-1	True	True	True
CGAGGCAAGTTCCCAC-1	True	True	True
CCTGTTGGTAAGGTTT-1	True	True	True
CAACTAGGTAACCAGC-1	False	True	True
CATCCCAGTTGTGACA-1	True	True	True
ACCACACCAGCACGAA-1	True	True	True
TAGTAACGTAAACAAG-1	True	True	True
AGCAAATAGTAAGTGG-1	True	True	True
AGTGAGTCAACTGGGA-1	True	True	True
CAACTAGGTCAATAGT-1	True	True	True
GACATAGAGCAACATC-1	True	True	True
TTTGTCCCACTAGGTC-1	True	True	True
ACCAAGCGTTAGGCTA-1	True	True	True
GACATTATCCTCAGTC-1	False	False	True
CATTTGTTCTTGATGA-1	True	True	True
AACATAGCATTGTGTG-1	True	True	True
CTGTATTTCATTAGCA-1	True	True	True
TGCTTCATCAGCTAAC-1	True	True	True
TTTGTGTTCCTGCGAA-1	True	True	True
GCCTTTGGTTAATGAC-1	True	True	True
TTATTGCTCAAGGACA-1	True	True	True
TGTAAAGCACTGGCTG-1	False	True	True
ATCATGTCAGGCTTGT-1	True	True	True
TTTAACCTCCTTAGGG-1	True	True	True
TCGTTATTCACTCAAA-1	True	True	True
CTCCCTGAGGACAATG-1	True	True	True
GTCGGTTCAAACCTAT-1	True	True	True
TCCTCAATCATGGTTA-1	True	True	True
TGGCCTTTCTGCAAGT-1	True	True	True
GATTAGTGTTGACTTC-1	True	True	True
GATAAAGGTTTGCTGT-1	True	True	True
GCATATATCCAGGTCA-1	True	True	True
ACGCTTGAGCACTAGT-1	True	True	True
TTTAACGAGTAACCCG-1	True	True	True
GAACTTATCGTCATTT-1	True	False	True
GATAAGCCATGCAACC-1	True	True	True
GCCCGTTGTCAGTAAT-1	False	True	True
GCGGTTGGTACCGGAT-1	True	True	True
CAACCCTTCCGCAACA-1	True	True	True
TGAACAACACCGTTCC-1	True	True	True
CACATACAGCACAGCC-1	True	True	True
CCCAAACCAGCAGGTA-1	True	True	True
TCCATCATCAGGCTAT-1	True	True	True
TCTACTAGTTGGGTTA-1	True	True	True
TGGGCATGTCAGGAAG-1	False	False	True
TGCTGGATCAGTATTG-1	True	True	True
GTCCAAGTCCATAATG-1	True	True	True
AAACCAACATAGCTGC-1	True	True	True
CTCCAACTCTTGAGGT-1	True	True	True
GATCGATTCATCACTT-1	True	True	True
GCCTTACTCCTTAGGG-1	True	True	True
GTCAATATCATGGCCA-1	False	True	True
CGACTAAGTAACGGGA-1	True	True	True
ATGCTTAAGGCTAATC-1	True	True	True
TCTTAGCGTGCTGGTG-1	False	True	True
CCTTACTCATAGTCAT-1	False	True	True
CAGGTCCAGTTATGTG-1	True	True	True
TCCCGTTAGCGCATTG-1	True	True	True
CTCACAACATCACAGC-1	True	True	True
CCAAACTAGGAAGCTA-1	True	True	True
GAAAGCCAGGGACTAA-1	True	True	True
GATTGCGTCGGGATTT-1	True	True	True
AACTTAGTCATTGTCT-1	True	True	True
AATGCAACATCACTTC-1	False	True	True
TGATGAACAGCTTACA-1	True	True	True
GTCGCAATCTTAGCCC-1	True	True	True
CTAGCTGAGGTAAGGC-1	True	True	True
ATGTCCACAGTATGTT-1	True	True	True
GAACCGCTCGGTTACG-1	True	True	True
TAGCTAGGTGTTTGTC-1	True	True	True
CGTTAACAGGTGAAGC-1	True	True	True
ACCCGGTAGTGAACGA-1	True	True	True
AGGTGAATCGGTAACT-1	True	True	True
TGCTATGCAAACCTTG-1	True	True	True
GCTGACATCAGAAACG-1	True	True	True
GCAGCTATCCTTGCAC-1	False	True	True
GAGGAGGCAATTGAGA-1	True	True	True
AAGTTAGCATAGCTGC-1	True	True	True
GATCACTAGTCACTAA-1	True	True	True
AGAAAGGCAGTAATAG-1	True	True	True
TATGGTCAGTACTGGT-1	True	True	True
TGGTCATAGTAGCGGG-1	True	True	True
GGCCATCAGGTGCGGA-1	True	True	True
AAAGCCGCAGCCTTGG-1	True	True	True
TCGGTAAGTAACGGGA-1	True	True	True
CTAGTTGCATTAGCGC-1	False	False	True
CGACTAAGTAGGTGTC-1	True	True	True
TTGGGTTAGAGAGCCG-1	True	True	True
CCTAAGCCAACTAGCC-1	False	False	True
GCTAAGTTCCTAAGTA-1	True	True	True
AATTAGCGTTACTTCA-1	True	True	True
AGGTGAATCTGTGAGT-1	True	True	True
CGTAATGGTAATGGCC-1	True	True	True
TGGCTTTGTGATGATT-1	True	True	True
AGCTTGGTCAGCTAAC-1	True	True	True
GGGTCAACAATGAGGT-1	True	True	True
GCATGAAAGGAACGCG-1	True	True	True
ACATTGCAGTCACCTC-1	True	True	True
TGGCCTTTCCCTTGCG-1	False	False	True
AGTGAACCACTTAACG-1	True	True	True
CATAATGTCGTCAAGT-1	True	True	True
GGTGATTTCAAACACC-1	True	True	True
CACTTAAAGGAGGCAT-1	True	True	True
ATTGCTCGTCAAACTG-1	True	True	True
TGTTGTGCAATCCTAG-1	True	True	True
CCGACAGGTTAGGCGT-1	True	True	True
CGTAGCGGTGTTGCAA-1	True	True	True
ACTTACTTCATCAGTA-1	True	True	True
ATCCACCTCATGTTTC-1	True	True	True
CGATGTCCACTTAACG-1	True	False	True
GTTTCCTCAATAACGA-1	False	False	True
CAGTACCCAATCCCTT-1	False	False	True
GCTAAGAAGGAGCACG-1	True	True	True
AGATGCTTCATCCACC-1	True	True	True
TGCATTAAGTCTGGGC-1	True	True	True
AGTAGGATCTTAGCGG-1	True	True	True
TTGTCCCAGGATCACT-1	True	True	True
TAGCCTGAGCTAATCA-1	True	True	True
GCAAACCGTGGCTTCC-1	True	True	True
AGGTCTTAGGTGAAAT-1	True	True	True
GAAAGCCAGTAACGAG-1	True	True	True
AGGGCCTTCGAGGTGG-1	True	True	True
CTGCTCCCACAATGCC-1	True	True	True
TGTCAATCACTAGCGT-1	True	True	True
GAAGTCAAGGGATGCG-1	True	True	True
GAAGTGATCAAACCTA-1	False	True	True
CTTGCGCGTTGAGCCG-1	True	True	True
CTACCTCAGCTGGAAA-1	True	True	True
TAGGAGTCAATCCTAG-1	True	True	True
GCCTTACTCACTTTAC-1	True	True	True
CATTGCGAGACAAAGT-1	True	True	True
TGTCAATCAAGCGAGC-1	True	True	True
TTTCTTGCACTAGGTC-1	True	True	True
CCCGTAAAGAGCAAGC-1	True	True	True
AACAGCAAGCATGTTA-1	True	True	True
TCCTAGTGTAGCTAAT-1	True	True	True
CTCAATAAGACTTATG-1	True	True	True
ACAAACTGTCGTAATG-1	False	False	True
ATGTTTGAGGAAGCTA-1	True	True	True
AGTGATGAGTTACTTC-1	False	False	False
AGGTTACTCCTGTTCA-1	True	True	True
AGTAGGATCATTACGA-1	True	False	True
TCCTCAATCCTGATTT-1	True	True	True
TGAGAACCACCTGCCT-1	True	True	True
GTCTAATCAGCTTACA-1	False	True	True
TGTGCACCACAGACTC-1	False	True	True
AGTTGCAGTTGCTGGG-1	True	True	True
ACTCAGTAGTTACCGG-1	True	True	True
GCTTCGCGTGGGTGAA-1	True	False	True
CCGCAAGGTGCGCAAT-1	True	True	True
GCTGCAATCCGTAAAC-1	True	True	True
TTGCTTTAGAAGCTAG-1	True	True	True
GCACTAAGTTTCCACG-1	False	True	True
AATCCCTGTTTAGCTC-1	True	True	True
ACCACACCACGGTTTA-1	True	True	True
TACTTGTTCTTGCTAT-1	True	True	True
AAGACCAAGGCGGGTA-1	False	True	True
TCGCTAACATAATGAG-1	True	True	True
TAGGTTGGTAACGAGG-1	True	True	True
GCTTCGCGTGGTTATG-1	True	True	True
GTAGCCATCTCCATAT-1	False	True	True
CTCTTGATCCTTCTAG-1	True	True	True
TCCTTTACACATGCTA-1	True	True	True
AATTTGCCATTGACAT-1	True	True	True
AGCAATACAGAATGAC-1	True	True	True
CAAGCTAGTTACTTGC-1	True	True	True
GCCACAATCATGCAAC-1	True	True	True
CGAATATGTGATTACG-1	True	True	True
TCTCACCAGCACGTTG-1	True	True	True
CAACTAATCATGTTTC-1	True	True	True
GTGCGGTTCGGTTTCC-1	True	True	True
AATATCCCAGTAAAGC-1	True	True	True
TAACCGGTCATTAGGC-1	True	False	True
GCCCTCATCCGTAAAC-1	True	True	True
GCATGAGCATTTAAGC-1	True	True	True
CGAACCGGTGCTGGTG-1	False	True	True
GACATTATCACACAGT-1	False	False	True
ATAATGGCACAACCTA-1	True	False	True
TCCTTCAAGACTATTG-1	True	True	True
GCGGTTATCCGCAAGC-1	True	True	True
CACATAATCTTAGTCT-1	True	True	True
TTTAACGAGACTATTG-1	True	True	True
TCTAAGGGTCTAACAG-1	False	True	True
TACTGACAGCGCATTG-1	True	True	True
CGCTAACCACCTCACC-1	True	True	True
CGCGGATTCTTGCAGG-1	True	True	True
GACAATACACTTCATC-1	False	True	True
CCTCAAACAACCTGGT-1	True	True	True
GAGGAGGCATTAAAGG-1	True	True	True
CAAGGTTTCCCTCGCA-1	True	True	True
GAATTTGTCACGCCAA-1	False	True	True
ACGCCTAAGCTAATCA-1	True	True	True
GCCCGTTGTCAAGTGC-1	True	True	True
GAAGGCTAGCCACAAT-1	True	True	True
TGAAACTGTGAACAAA-1	True	True	True
ACTCACCTCGCCTAAG-1	True	True	True
GAAGCCTGTTCCAGGG-1	True	True	True
TATCACAAGTGAAGTG-1	True	True	True
ACCATAATCATGCGTG-1	True	True	True
TTTAACCTCCATAATG-1	True	True	True
TGGACCGGTAAAGCGG-1	True	True	True
TACCTTAGTTTGGCTT-1	False	True	True
GTTAGACTCAAATCGC-1	True	True	True
CAGAACCGTCTAACCT-1	True	True	True
AGTGCGGAGCAGCTCA-1	True	True	True
CTAACCTGTCTCACTG-1	True	True	True
TGTGGCGGTTAGGCGT-1	True	True	True
AGCTTGGTCCGTGACA-1	True	True	True
GGAACCACAAACCTAT-1	True	True	True
ACTTCGCTCGCTAGAT-1	True	True	True
TCACATAAGGCGCATC-1	True	True	True
ATGTTCAAGCAATAGG-1	True	True	True
TGAGCCGGTGCCGCAA-1	True	True	True
ATGGTGCGTGTTGCTT-1	True	True	True
CAAACATGTGTAACCA-1	True	True	True
GAGCAAGGTCCCGAAG-1	True	True	False
AACTTAGTCAAGTGTC-1	True	True	True
CGGCTAATCCTAACGG-1	True	True	True
AAGTTAGCACCTATAG-1	True	True	True
ACGCCACAGATAACCC-1	True	True	True
TGGTCCTTCTGTTCAT-1	True	True	True
GGGTTTCCAGGGAGCT-1	True	True	True
CATGCATAGTATTGGC-1	True	True	True
GCCTACTTCGTTCACC-1	True	True	True
TACGCACCACTGACCG-1	True	True	True
GGAAGTATCAATCTCT-1	True	True	True
CCTGAATAGATAGACG-1	True	True	True
TCTCAAGCAGCTACGT-1	False	True	True
ATCGAGGCAGGTATTT-1	True	True	True
TTGCAATCATAGCTGC-1	True	True	True
CGTGTTACAAGGTATA-1	False	False	True
GGGAATATCTCGACCT-1	True	True	True
AATGTCATCGGTACGC-1	True	True	True
ACGACAAAGGAGGACT-1	True	True	True
TGGGCCTAGGTCCTAG-1	True	True	True
TCCTCTAAGCTGTCAG-1	True	True	True
AGTGCCGGTCCACAAA-1	True	True	True
ATTGCGCCAACAGGTG-1	True	True	True
ACCACACCACCTAATG-1	True	True	True
ATGAGCCGTCAAAGAA-1	True	True	True
CAGGCTATCCGCCTAT-1	True	True	True
GTGCTGATCCGTTAAA-1	True	True	True
GCTCTGGCAATAGCAA-1	True	True	True
TAGCCTCTCAATAGCC-1	True	True	True
GCAGCAACAGGCTTGT-1	True	True	True
AAGTTACGTTCACCAT-1	True	True	True
AGCGTGCTCTCAATAG-1	False	True	True
ATTACCGCAAGCGATG-1	True	True	True
AGAGATTAGTCAATTG-1	True	True	True
GCAAACAAGTTGTCCC-1	True	True	True
AGCCTAGTCCTAAGAC-1	False	True	True
TTTGACCGTAGGTTTG-1	True	True	True
TTACAGCAGCTTTGGG-1	True	True	True
ACTATCCGTTGCGCGA-1	True	True	True
CCCTGGACAACCCTCC-1	True	True	True
ACCTCACTCCTTGAGG-1	True	True	True
AACGACAAGGCATTAC-1	True	True	True
CACTTAAAGCACCACA-1	True	True	True
TGTCATAAGTGAGCAA-1	True	True	True
ATCATGTCAGTGAACG-1	True	True	False
GCCCAAATCCCTGACT-1	True	True	True
TGGAACAAGCCGCTAA-1	True	True	True
GATGCGACATGTTTGG-1	True	True	True
CCGCAAATCCAACTGG-1	False	True	True
CACGCAATCATGCCTC-1	True	False	True
CAACAATGTTCGGGAT-1	True	True	True
GAAAGGCTCGCAACAT-1	True	True	True
TTGTGCGAGTTTCCTG-1	True	True	True
CGCCTGTGTTGCAGTA-1	False	False	True
CGGGTCTAGGCGCATC-1	True	True	True
TATGACATCGTGCCTT-1	True	True	True
AACATTGTCAGCATTA-1	True	True	True
ATTATCCTCCTAGTAA-1	True	True	True
TCACTGACAATTTAGC-1	True	True	True
CCTGTTGGTCCAAATG-1	True	True	True
AGGCAATCATAATCGT-1	False	True	True
GGATTCAGTCAAGACC-1	True	True	True
GGGTTTGTCCATTACT-1	True	True	True
ACATTGCAGATGGACA-1	True	True	True
GTTGCATAGTAATCCA-1	True	True	True
CTGGCTAAGGGCTTAT-1	True	True	True
AAGCTAGAGTCATGCG-1	True	True	True
ATGACTCAGCCTGACA-1	True	True	True
TAGCCTCTCGTTATAG-1	True	False	True
TTGGCTGAGGAGCAAC-1	True	True	True
GTAGGATCAAGTGAAC-1	True	True	True
CTGCTACTCAGCACCA-1	True	True	True
GCTATCCTCTTGAGGT-1	True	True	True
ACGACTTAGTTAGAGG-1	True	True	True
AGAACCGCATCAGCAC-1	True	True	True
ATTAGTCCAGGATAAC-1	True	True	True
TTTAAGCCAGCACGAA-1	False	True	True
ATGGACAAGGCGCTAC-1	True	True	True
GTACAATGTCTTTGAC-1	True	True	True
ATCATGTCACTTACAG-1	True	True	True
TGTTGTGCACGTGCTG-1	True	True	True
AGGTACGCAATAGCCC-1	True	True	True
CGCCTGTGTGTGCACG-1	False	True	True
TATCACGCATTGACAT-1	True	True	True
ATGTAACGTAAGCACC-1	True	False	True
GGGTTATTCATTGACA-1	True	True	True
GTGAATCTCCCTGTTA-1	True	True	True
GGACCTCAGTAGGATG-1	True	True	True
AACATTGTCCAGGTTG-1	True	True	True
AGGACGTAGCGCAATT-1	False	True	True
TTTAGCTTCTTTGTAC-1	True	True	True
TGTTGTGCAGGACACA-1	True	True	True
TACCTGCTCGTTAGCG-1	False	True	True
CCAAGTTAGAGGATAT-1	True	True	True
GCGGATACACCCTCAC-1	True	True	True
AACTTAGTCTAAGTCA-1	True	True	True
GTGAACAAGGACCTCA-1	True	True	True
AACCGCTCAAACTAAG-1	False	True	True
TTGTCCGGTACTGATG-1	True	True	True
ACCAGCTCACGCAACT-1	True	True	True
CGGTAACGTGGACCTG-1	True	True	True
CAACTAGGTGCCGCAA-1	True	True	True
CCATAAGGTTCCGGCT-1	True	True	True
GTCTTTAGTAAAGCAA-1	True	True	True
CCTGAATAGGCTGTGC-1	True	True	True
TTGCAACAGGGACCTC-1	True	True	True
AAGGTATAGGACAATG-1	True	True	True
TGCGATTAGCAAACCT-1	True	True	True
AGTTGCGTCATAGACC-1	True	True	True
CCAAACCCAGAGGCTA-1	True	True	True
GTTTGTTTCATGACCG-1	True	True	True
TGGCTAAGTAAAGCGG-1	True	True	True
TTCAGGTAGTCGCTAG-1	True	True	True
CCATTATTCGCGCTAA-1	True	False	True
GTTAACGGTAATGGAA-1	True	True	True
GCTAACCCACTTAACG-1	True	True	True
TATATCCTCCCGTTTA-1	True	True	True
CCACAATAGGTAGCTT-1	True	True	True
CTTAAGATCTTGAGGT-1	True	True	True
GAGTCAAAGTCCTTCA-1	True	True	True
ATATGGTGTAAGGTTT-1	False	True	True
ATGTAACGTAATCACG-1	True	True	True
GAAGTAAGTCCGCTGT-1	True	True	True
CAATCCCTCGAGGAAC-1	True	True	True
GTAGGTGCACAGACTC-1	True	True	True
CAAACTGGTTCCGCAC-1	False	True	True
TTGCTCTCAATTGACT-1	True	False	True
TGTAAAGCATAAGTCT-1	True	True	True
CCTAAGTAGTTTGCGG-1	True	True	True
CATAGCTAGTTACCGG-1	True	True	True
CTCGACAAGGACACTT-1	True	True	True
GCCCATAAGCCTAACG-1	True	True	True
GTCGGTTCATAAGTTC-1	True	True	True
CGTCCTAGTCAAGTGC-1	True	True	True
AACTAGCTCTTTGACT-1	True	True	True
GAAAGGCTCAAGCTTA-1	True	True	True
CTAGTTGCAAACTGCC-1	False	False	True
TGCTAGCCATAAACCT-1	True	True	True
GTCCGTAAGCATTTCT-1	True	True	True
GAGTAATAGTAACTCA-1	True	True	True
AATGCGCGTGGACCTG-1	True	True	True
CCGCACACAGCAAGGC-1	True	True	True
CAATATGTCCATAATG-1	True	True	True
GTGTTCCTCCCATAGG-1	True	True	True
TATAGCCAGTAAACCC-1	True	True	True
TATTAGGTCCTCAGTC-1	True	True	True
TTGGATCAGCCTGACA-1	True	True	True
AGCCTAAGTTGACTTC-1	True	True	True
CATCAATCAAACGGGC-1	True	True	True
AGCAAGGGTTCCTCCT-1	True	True	True
TAGTAAGCACTTCATC-1	True	True	True
CTTATTGGTGAAACAA-1	True	True	True
TGTTTGTTCGTTTCTG-1	False	True	True
TACCTGCTCATAACTG-1	True	True	True
GGGAGTAGTCTTGCAT-1	True	True	True
GCTGCATCAGGAATCG-1	True	True	True
ACAGTATGTGGGTGAA-1	True	True	True
TAAGCCTAGTTAGCCG-1	True	True	True
TTAGCCTGTGTGAGAG-1	True	True	True
TGGACAAAGGAGCAAC-1	True	True	True
AGGTCAAAGGCTAAGA-1	True	True	True
GGTTACCCAGTTATCG-1	True	True	True
GGAACTAAGCTGGAAA-1	True	True	True
TCTACTAGTGATGGCT-1	True	False	False
TTAGCCTGTGTGTCCC-1	False	True	True
CGGATTAGTTTACTTG-1	True	True	True
GAGCCACTCGGCTAGC-1	True	True	True
CGACTAAGTAGGATCC-1	True	True	True
GCGCTAGGTAGCTAGC-1	True	True	True
CACCTGTTCCAAGTGT-1	True	True	True
ACCTCACTCAATGACC-1	True	True	True
CGAATATGTTCGGGAT-1	True	True	True
CTTACCGGTTAAGTGT-1	True	True	False
CAGGACACAGCTCATA-1	True	True	True
GGCTATGTCGTGCTTC-1	True	True	True
ATGTTTGAGTGAAGTG-1	True	True	True
GTGCCTTTCGATTTGA-1	True	False	True
GCCTTGCGTGTTAGCA-1	True	True	True
TCACCTGGTTACAACG-1	True	True	True
ACTAGGCGTAGGATTT-1	True	False	True
GGCCGTTAGTCAATCA-1	True	True	True
CAGCATGTCTTAGCCC-1	True	True	True
CCAACCCGTTTGGGCG-1	True	True	True
CTTGTCCAGGTGTCCA-1	True	True	True
CCAACATAGTAAGAAC-1	False	True	True
TAGCTAGGTGCTTTAC-1	True	True	True
TCTATGTTCAGTATTG-1	True	True	True
TCACATAAGTCACGAT-1	True	True	True
TGAACAACAAGGACCA-1	True	True	True
ATTACGTCACACCAAC-1	True	True	True
AAAGGCTCACCAGGTT-1	True	True	True
TGGTTCTGTTAGGTTG-1	True	True	True
TCCTTGCAGGCAGGTG-1	True	True	True
AACCTTGCAGCAAGTG-1	True	True	True
AAGTCTATCCCTCAGT-1	True	True	True
CGATGTCCAAGCTAAA-1	True	True	True
TGTAAGTGTAATAGCT-1	True	True	True
CAGATTCAGATTGAGG-1	True	True	True
TTGGCTTGTTTATCTG-1	True	True	True
GCGAGTGAGCTCCTTA-1	False	True	True
CGCATATAGGAAGCAC-1	True	True	True
GCTAGTGTCGATAACC-1	True	True	True
CATCATGCAGCTAATT-1	True	True	True
GACTTGGTCTCCTCAA-1	True	True	True
CTAAGGTTCTTCAATC-1	True	True	True
CCTGAATAGTCATTTC-1	True	True	True
GACCTGATCAGGAAGC-1	True	True	True
GGCCATCAGTGAACCT-1	True	True	True
CTAAATGTCGCTATGG-1	False	True	True
GATGACTTCTTGCATT-1	True	True	True
TCCTTAGTCGATATTG-1	True	True	True
GAAGGCCCAAGTGAAC-1	True	False	True
AATTACCCAACCCTCC-1	True	True	True
AGGTTAACAACTAGCC-1	False	True	True
GTGCTCAAGGACCTTG-1	True	True	True
AGCCTAAGTCGTAAAT-1	True	True	True
GCCTTGCGTTTGTGGA-1	True	True	True
GTGCAAGCAACATAAG-1	True	True	True
AGGTTGCGTCTTTGAC-1	True	True	True
GCCAGGAAGTTATGGC-1	False	True	True
GAGCTTAGTTGCAATG-1	True	True	True
ATTGGTTCAGGTTAAA-1	True	True	True
GGCAGGATCCTCAGCT-1	True	True	True
CCTTGTTCATCATGGC-1	True	True	True
TCCACAACAGCATTAT-1	True	True	True
TGTTCCTCACCTCACC-1	True	False	True
GCATGAGCACCAAAGG-1	True	True	True
CCACTTGGTTCACTGT-1	True	True	True
GAACCTGTCAATGTCA-1	True	True	True
CTGTTTAGTTACAACG-1	False	True	True
TACAATGTCGGGCCAT-1	True	True	True
TTACAGCAGTCCTTCA-1	True	True	True
GTCTTGCTCCAGCACA-1	True	False	True
CCCAAACCACCCACCT-1	True	True	True
AACCTTAAGTGAGGTA-1	True	True	True
CTTGAATCAAGGTGCA-1	True	True	True
TTTGCGACAGGCATGA-1	True	True	True
CTTAATGAGACTTACA-1	True	True	True
CGGACAACATTCCTCG-1	False	True	True
GCTAAGCGTGCTCCAC-1	True	True	True
GAGTTGCGTCAGGAAG-1	True	True	True
ACGTACCCAAGGTACG-1	True	True	True
GTTACGCCATTGGGAG-1	True	True	True
ATCCAACAGAGGAGTC-1	True	True	True
CTATGGCCACACCAAC-1	True	True	True
AGTCCTGAGGCAACAA-1	False	False	True
TGCAATATCAAGTGAG-1	True	True	True
GGCCTAATCGGGCCAT-1	True	True	True
CGATTATCAGGTCCTG-1	True	True	True
AGCCGGTTCAATCATG-1	False	True	True
GCCCTCATCCTCATCA-1	False	True	True
TCAGGTTAGAAGCTAG-1	True	True	True
ATCAATCCACCAACCG-1	True	True	True
ACTTGAATCCTGATGG-1	False	False	True
ATAGGTACAGGTCCTG-1	True	True	True
GCAATGAAGGCTAATC-1	True	True	True
TGCTAACAGTTATCCT-1	False	True	True
AGGTACGCAGGGAGCT-1	False	True	True
AAGCCACGTGAGAAAC-1	False	True	True
TGGCCAATCAAATCGC-1	True	True	True
CCTCAGTTCCTGGTCT-1	True	True	True
ACCAATATCGAGGTGG-1	True	True	True
AGTTTGCAGCTGCACA-1	True	True	True
GTTAACGGTCCTAGTT-1	False	True	True
CAAACAACAAACGCGA-1	True	True	True
GCTTAAATCACGAATC-1	True	True	True
CCTTAGTGTTTGAGCA-1	True	True	True
AGGATGTCACCCTCAC-1	True	True	True
TTAGTCAAGGCCTTAG-1	False	True	True
GATTCGCCACAGGAAT-1	False	False	True
GCCTGCTGTTGCAATG-1	True	True	True
CTCCTCACATTGTTGG-1	True	True	True
CTGTTCATCCCGAAGC-1	False	True	True
GTCATGCCATAGACCC-1	True	True	True
GGGCGAATCGGTTTGG-1	True	True	True
CAATCGCCATGCTTAG-1	True	True	True
ACAGTATGTTCGGGAT-1	True	True	True
GTTACCTGTTAGGCTA-1	True	True	True
CTACGAAGTGATGAAA-1	True	True	True
CCGCAAGGTGTGCAAC-1	True	True	True
GTAAAGCCAAGTCGCT-1	True	True	True
TCCTTTACACTAGCGT-1	True	True	True
TTGGATCAGGGTGAAC-1	True	True	True
TACGTAATCTTTGAGA-1	True	True	True
TGGTTCTGTTGGTGAC-1	True	True	True
CTAAGTCAGTAAGGGC-1	True	True	True
GTTCGCTTCACAAGCT-1	True	True	True
TGAAGGATCAATCTAG-1	True	True	True
CTATAACCAGTAATAG-1	True	True	True
TAGGAGTCAATATACC-1	False	True	True
ACTTTGTTCTACCTGC-1	True	True	True
CCACAATAGGCTTAGT-1	True	True	True
ATTGCACAGTCACCTC-1	True	True	True
GCTTTGTGTTTCGCGC-1	True	True	True
GTCCTAGAGCCTGATG-1	True	True	True
AAGAATCAGTGAGGGT-1	True	True	True
GCTCTGTTCTTGACCC-1	True	True	True
TCCTGGTTCGTTAGTA-1	False	True	True
GTGCTTCTCCTGCGAA-1	False	True	True
CAACCCGCACATACTG-1	True	True	True
TCGTTAGCAGGATGGC-1	False	True	True
TACTGAGGTCACTCGC-1	False	True	True
GCAATGAAGGCATTGT-1	True	True	True
CGACCTGCAAGATTCT-1	True	True	True
CATGCGGGTCCAAGAC-1	True	True	True
CGCTGTGCAATGAAGC-1	False	True	True
AGTCAGGCACAACAAA-1	True	True	True
TAGCCGGGTGTGTGGT-1	False	False	True
CATAATGTCGTCATTT-1	True	True	True
AAAGGTTAGGACGTAA-1	True	True	True
GTGAATCTCCTGTTCA-1	True	True	True
TAGACCAGTATTGCAG-1	True	True	True
GAGTTACTCACTCAAA-1	True	True	True
TTGTTGCGTACGGTAC-1	True	True	True
GTGTTACAGGTCCACA-1	True	True	True
TGATTGCAGTTTCCGC-1	True	True	True
GTGTTACAGCGGTTAT-1	True	True	True
TTGTTGTTCACAGCGC-1	True	True	True
ACCGGCTAGCAAGGAC-1	True	True	True
TAAGCCAGTGGATGTC-1	True	True	True
TTGAGGCGTAGCTAGC-1	True	True	True
AAGCTATGTCAGGAAG-1	True	True	True
TCGTGCTTCATGCAAC-1	True	True	True
TATGACTCATTAAAGG-1	True	True	True
GAGTATCTCTCTAGCC-1	True	True	True
GAAGTCAAGGGTGAGT-1	True	True	True
CGTGCTGCATAAGTTC-1	True	True	True
ACCCTGTTCATTTGTC-1	True	True	True
GATTATGTCAGCAAGA-1	False	True	True
GATTAGTGTTCGCTTG-1	True	True	True
GTATTGCAGTTTGCGG-1	True	True	True
AGCGTGCTCCTAATGA-1	True	True	True
CGTTGCAAGAAGGTGC-1	False	True	True
TCACATAAGCGATAGA-1	True	True	True
CAAAGGATCAAGACTC-1	True	True	True
AATGTCATCATTAGCA-1	True	True	True
CAGGGCTTCGCTAAGT-1	True	True	True
CATTGTGCAGAGAGCC-1	True	True	True
GGCGGTTTCCAAATCA-1	False	True	True
TAGTCAATCTGTAATG-1	True	True	True
TTGCGAGTCCATAATG-1	True	True	True
TATCGAGGTCGCAATA-1	True	True	True
AGGCAGGTCTTGAGGT-1	True	True	True
TCGCCCATCCTCACTA-1	True	True	True
GGCGTTATCTTAAGTG-1	False	True	True
CATATCGCATCGCTCC-1	True	True	True
GCAAGTGCAGCTTAGC-1	True	True	True
CGCAAATTCGAAGTGA-1	True	True	True
CGATGTCCAATTAGGA-1	True	True	True
GGTTATATCGATATTG-1	True	True	True
TATGACTCAGCACCAT-1	True	True	True
CTACCTCAGACAGGTA-1	True	True	True
TCCATATTCACGAATC-1	True	True	True
GTAAGGTCATTAGCGC-1	True	True	True
GCCTTAACATGAAGTA-1	True	True	True
AGAACAAGTGAGGTAG-1	True	True	True
GACACTAGTAACAGGG-1	False	False	True
TTTGTCTAGTTCCTCA-1	False	True	True
CAGCCTTTCCCGTTTA-1	True	True	True
CCTTGTTCAGGGAGCT-1	True	False	True
GCTCATTGTCCAAATG-1	True	True	True
TTAGAAGCAGAAATTG-1	True	True	True
TTTCTCACAGGACCTT-1	True	True	True
TTAAAGGCAATTGAGA-1	True	True	True
TAAGCCAGTTTGTTGC-1	True	True	True
GGTATTTCAATTGAGA-1	True	True	True
TCGCTAACAGAACCGA-1	True	True	True
GCAAACTTCTAATCCT-1	True	True	True
TGTGCGGGTTTGTTGC-1	True	True	True
ACTCCTCAGGACCTGC-1	True	True	True
GGAGCATAGAGGATAT-1	True	True	True
TAAGTAGCAGTAGGAT-1	False	True	True
TACTCAAAGCTATTAG-1	True	True	True
TGAGTGAAGCTTACTT-1	True	True	True
GGGCAATAGCGATACT-1	True	False	False
ACTTAGGGTGACATAT-1	True	True	True
ACGCACGGTGTTGCTT-1	True	True	True
TTCGTGCTCACTAAGC-1	True	True	True
TCGGTTCTCGCTATGG-1	True	True	True
CGTGCTTTCAATTACG-1	True	True	True
TGGATTCAGTTAGAGG-1	True	True	True
GGCGTTATCTAATCTC-1	True	True	True
GTCGAGGAGTTGGCCA-1	True	True	True
GCGCAAACAGGATGGC-1	True	True	True
TGCCTGTTCTCCATAT-1	True	True	True
GGTACCGGTAGACAAA-1	True	True	True
TTGATGTCAAGGGTTG-1	True	True	True
TACGTTAAGTGACCTG-1	True	True	True
TCAACAATCGCTAAGT-1	True	True	True
TACCAAATCATTGACA-1	True	True	True
GTTAAGTGTCTTGCAT-1	False	True	True
GAATTTGTCGTTTCTG-1	True	True	True
GTACGTAGTCGACTCC-1	False	False	False
ATTAACCCATCACAGC-1	True	True	True
AACATAGCAAGGACCA-1	True	True	True
GGCGCTAGTCACAGAC-1	True	True	True
AAGTTTGTCTGTGCCT-1	True	True	True
GGTCCATCATAATCCG-1	False	True	True
GCTATCCTCGCTTGCT-1	True	True	True
CTTAAGATCTCACAAA-1	True	True	True
TTAGCCTGTAGGATCC-1	True	True	True
AGCTTAATCGTGCTTC-1	True	True	True
TTGAGGCGTAATTAGC-1	True	True	True
GTAGGCGAGGAGGTTA-1	True	True	True
AACTGTTCACGTGCTG-1	True	True	True
GACCTGATCCGCTAGA-1	False	True	True
ACCAAACTCGGTTACG-1	True	True	True
TCAATCGCAGGCTAGA-1	True	True	True
CGGCTCACATGTCAGC-1	True	True	True
GCAAACTTCCTTGAGG-1	True	True	True
TGCCTGTTCGCCTAAG-1	True	True	True
TACATCAAGGAACACA-1	True	True	True
TGTCATAAGTCTTGAA-1	True	True	True
TCCGGTTTCCGGCTAA-1	True	True	True
CGAGGTGAGCGCTAAT-1	False	False	True
GTACTTCGTAACCAGC-1	True	True	True
ACGGTACGTTACTTCA-1	True	True	True
AGCAATACACATTAAC-1	True	True	True
AAGCCACGTTATTGCC-1	True	True	True
GAGTTTGGTTCATCTA-1	True	True	True
CGTTAACAGCACGATT-1	True	True	True
GGCTAGACACCTACTT-1	False	True	True
CAGCCTTTCAAGTGAG-1	False	True	True
AGCTTAATCAAAGGCA-1	True	True	True
TTATCCTAGTTGGGCC-1	True	True	True
GGTGTCCAGGACTTAC-1	True	True	True
AACGGTAAGTGCTGTG-1	True	True	True
TACAACATCCGCATGA-1	True	False	True
AACAAGCCACAAAGCG-1	True	True	True
GTCATCCTCCCGAAGC-1	True	True	True
ACAAAGGTCGTGCTTC-1	True	True	True
TCTTCAAGTCATCAAG-1	True	True	True
ACTTATCTCACCGGTA-1	True	True	True
TGTCAGTAGCCAAATC-1	False	True	True
ACACGGACAACCGCCA-1	True	True	True
GTACAATGTTGGTTCT-1	True	True	True
CTTGTTTAGTTATTCC-1	True	True	True
GGAGCAAGTTTAACCC-1	True	True	True
GTTGCCCGTAACGTGC-1	True	True	True
GTTCCCAGTGATGATT-1	True	True	True
GCGATTTAGGTTTACA-1	True	True	True
AGAGAAGCACAAAGAC-1	True	True	True
GGTAGGAGTAGTTGGC-1	True	True	True
AATTGTGTCACGCGGT-1	True	True	True
GTTCCTGGTTAGAGCC-1	True	True	True
TGTCCTTCAGCCTGCA-1	True	True	True
CGAGCTGGTAATAACC-1	True	True	True
TCCATCATCCACCTGT-1	False	True	True
GGTTACTAGTCACGAT-1	False	True	True
CCTGTTGGTTAGTTGG-1	True	True	True
GCAAGTCGTAGGTTGC-1	True	True	True
ACGCCTTTCGGTCAAT-1	True	True	True
CCTAATAAGGTCCAAT-1	True	True	True
CTCATTGTCATAGACC-1	False	True	True
TCCTCACAGGCGGATG-1	False	True	True
GTTGCTGAGAACCTGT-1	True	True	True
TTGCTCTCAAGGTGCA-1	True	True	True
AGGTGAATCCAATAGC-1	True	True	True
TGAGCACGTCATTAGG-1	True	True	True
GGCTTCAAGGCCTGGT-1	True	True	True
CAGGTGGAGGCTGTGC-1	True	True	True
GTCTTTGTCTTGCAAA-1	True	True	True
TGTGGCTCAGCAGGTA-1	True	True	True
TATCCAGCAGGCCATT-1	True	True	True
TGGTAAACATTGCGAC-1	True	True	True
TTGACATCAGCACGTT-1	True	True	True
ACGCCACAGCCTGATG-1	True	True	True
GATTGATGTAGCCTCC-1	True	True	True
CACATTAAGCAGCTCA-1	True	True	True
GTTTGTCGTCCGTAGG-1	True	True	True
GTTAATGTCCTCACTA-1	True	True	True
CCTTCAATCCTGATGG-1	False	True	True
TATTTGGAGTTTCCGC-1	True	True	True
CCAGTTTGTTACATCC-1	True	True	True
GTAGGAGGTCAAGACC-1	True	True	True
TCTCAATTCTAACCAA-1	True	True	True
CACCAACCACAACAAA-1	True	True	True
AATGCGCGTTTCCACG-1	False	True	True
GTTCCTGGTAGCCTCC-1	True	False	True
AGTGAACCACCTGTAA-1	True	True	True
AATCCATCAAGTGTCC-1	True	True	True
CCTTCAGGTGCCGCAA-1	True	True	True
GCTGACCAGGCATGAA-1	True	True	True
GTCGCAATCAGCATTA-1	True	True	True
GAGCGAAGTTTAGCTC-1	True	True	True
GTTACTAAGGATAAAC-1	True	True	True
TGTAAAGCATTAAAGG-1	True	True	True
GCTGCACAGCATGAAG-1	True	True	True
GGTTGACGTATTGTCC-1	True	True	True
GCAATGTTCGGCTATG-1	False	False	True
GCAAGTCGTTGCCTCA-1	True	True	True
ATAGCATGTGATGGCT-1	True	False	True
GGAGTGAGTCATCCTG-1	True	True	True
GCCCAAATCGAAGTGA-1	True	True	True
AAGCTATGTGTGCACG-1	True	True	True
GGTTTAATCGGCTAGC-1	True	True	True
CTGAATATCAAGCTTA-1	True	True	True
GTCCTCCCATAATTGC-1	True	True	True
GATCAGGCAGTTTGGC-1	True	True	True
GGAAGCTAGGTTACGT-1	True	True	True
CCTACTTCAGCAAGGC-1	True	True	True
ACGGTTAGTTAGAGGG-1	True	True	True
CCGTTACTCGCTATAA-1	True	True	True
TACGCTTGTTACTTCA-1	True	True	True
GTTACGTAGCCACAAT-1	False	True	True
TATATCCTCAATGAGG-1	True	True	True
CTCCTCACAAGATTCT-1	True	True	True
TAAACAGCAGGAATCG-1	True	True	True
CTCCTAATCTTGCTAT-1	True	True	True
GTGCTTCTCGCTCCAT-1	True	True	True
GCTAACCCAGTAATAG-1	True	True	True
GCCTTTATCATAACTG-1	True	True	True
CCAGCTAAGTAACTCA-1	True	True	True
CAACTAATCAGGCCTA-1	True	True	True
ATGTCAATCAGGATGA-1	True	True	True
ACGGTTTAGCCAGGTC-1	False	True	True
AGGTGAGGTTCATCTA-1	True	True	True
ACAGGAATCTTGTCTG-1	True	True	True
CCCATAACAAACCTAT-1	False	True	True
TTATCCGTCACAGCCA-1	True	True	True
CGCGATTCAGTTTGGC-1	True	False	True
TAGCGGCTCCTTAGGG-1	True	True	True
ATGGCTTAGTCACCTC-1	False	False	True
AATGCATGTTCCGGGA-1	True	True	True
GAGGCAAGTTATAGCG-1	True	True	True
GGCAAATCAAAGCTAA-1	True	True	True
TGGACGGAGCATGACT-1	True	True	True
GTTTGTAAGAACAAGT-1	True	True	True
CGTTTCTCAAGGTCCT-1	True	True	True
ATCTATGAGTTGCGTG-1	True	True	True
TCAACAATCACGCATG-1	True	True	True
CTCTAAGCAATACTGT-1	True	True	True
TATCCAGCAGTTTGTG-1	True	True	True
GTTCTTAGTACCGTTT-1	True	True	True
AGAACAAGTGGTTCCC-1	True	True	True
GCGCCTTGTGGAGCAA-1	True	True	True
CACATTAAGCATTTCT-1	True	True	True
GATTGCGTCGGTTCCT-1	True	True	True
GGCTGTCAGCATTATG-1	True	True	True
GCTGTAAGTGAAGCCT-1	True	True	True
AGTTATGTCAGGGCCT-1	True	True	True
TAGCGGACAATTAGGA-1	True	True	True
CGGGACAAGACTATTG-1	True	True	True
CGGTTATAGTCTGGGC-1	True	True	True
CATGGCGGTTATAGCG-1	True	True	True
TATGAAGCACATAGCC-1	True	True	True
TAGTGTGGTCGCAATA-1	True	True	True
TTGGGCGGTGGACCTG-1	True	True	True
TGAACAGAGGCCTGGT-1	True	True	True
TGGACCGGTTAACGGC-1	True	True	True
TCATGAGGTTAAGCCA-1	True	True	True
ACATCAATCTCACTCA-1	False	True	True
ACGACAAAGGTAAGGC-1	True	True	True
ACAGGTAAGACAAACG-1	True	True	True
AACTAGTGTTTAACCC-1	True	True	True
CCATCACTCGCAAACT-1	True	True	True
TCGCCCATCATGCTAA-1	False	False	False
TGCAGGCTCGAAGCGG-1	True	True	True
TCTAACCGTTCGCTCA-1	True	True	True
CGTAGTTAGAGGAAGG-1	True	True	True
GTGCCTTTCTAGCGTG-1	False	True	True
TCAATCGCATCTTGAG-1	True	True	True
TGCTTGTGTTACTTGC-1	True	True	True
GCCTTACTCGCACAAT-1	True	True	True
TCTACTAGTTGTGATG-1	True	True	True
GTCCTAGAGTTGCCTC-1	False	True	True
TGATCCTGTTGAGCCG-1	True	False	True
ACTGAAACACAAAGAC-1	True	True	True
CCTAGTTGTCACCAAA-1	True	True	True
TGCATTAAGTGAGGTA-1	False	True	True
GGGTCACTCATTATGG-1	True	True	True
TTCGTGCTCTAGCGAT-1	True	True	True
ACCTTGTGTTGTTGTC-1	True	True	True
GATTGTTCAGGGAGCT-1	True	True	True
GTGGCTTCAGAAATTG-1	True	True	True
TCGCTAACAGGTTACC-1	True	True	True
GGCGGTTTCCGCAAAT-1	True	True	True
TAACAAGCAACAGCCT-1	True	True	True
GGATTATGTTGCTGGG-1	True	True	True
CTTCGCGTCCACCCTG-1	True	True	True
TATGGTCAGGTCCAAT-1	False	True	True
GTCATCCTCCTGAATA-1	False	True	True
AGGTGAGGTAGGATCC-1	True	True	True
AAGCGCTGTCATAAGT-1	True	True	True
GTACTAATCTTGCTAT-1	True	True	True
AATGGCGCATAATTGC-1	True	True	True
CAAGCTAGTGCACGCA-1	False	True	True
TTCATCCCAGGATGGC-1	True	True	True
ATTCGTTTCGTTCACC-1	True	True	True
AGGAACCAGCGCATTG-1	True	True	True
CTAACCTGTCCGTAGG-1	True	True	True
CTCACTCAGAGGATAT-1	True	True	True
ACGTCCTTCATTGACA-1	True	True	True
GCTGCATCATGGCCTG-1	True	True	True
ATTGAAGCACGAACAG-1	True	True	True
CGTACGGGTCATAAGT-1	True	True	True
GAGAGGCGTCCACAAA-1	True	True	True
TTACCTGTCCAATAGC-1	True	True	True
AATTGGGAGCAAGGTA-1	True	True	True
GCATATATCCTCCCTC-1	False	True	True
CATTATGAGGTCTTGG-1	True	True	True
GGATATTGTTGTGATG-1	True	True	True
GTTAGACTCCCATAAA-1	True	True	True
TCCTAGTGTGAGAAAC-1	True	True	True
ACTCAGTAGGAAGCTA-1	True	True	True
ATTATCCTCCTTAGGG-1	True	True	True
TACAGGTTCGATTCTT-1	True	True	True
GTTCGCTTCGCAACAT-1	True	True	True
TGAGGAGGTAAGCTTG-1	True	True	True
GTTACTAAGAAAGGAA-1	True	True	True
TAGCAGGCAGAAATGC-1	True	True	True
ATTATGGTCATAATCG-1	True	True	True
GCAAACCGTACTTAGG-1	True	True	True
TAGCCGGGTGAACAAA-1	True	True	True
ACGCCTAAGTTTCCTG-1	True	True	True
CGTCCTAGTAAGCTCA-1	True	True	True
AAGCCTCCAAGGGTTG-1	True	True	True
ACTAACGGTGTCCAAA-1	False	True	True
GACCTTTGTATTCGTC-1	True	True	True
CTAGTCGAGCACTTGG-1	True	True	True
GCAGGCTTCTTGCATT-1	True	True	True
CAGGGCTTCTCCTCAA-1	True	True	True
CTAATTGAGTCCTTTG-1	False	True	True
TAGCCGGGTGGTGAGA-1	True	True	True
AGTCGCATCTTAGGGT-1	True	True	True
TCTGTGACACAACAGG-1	True	True	True
CGATGTCCATAGACTT-1	True	True	True
GCTTAGTAGACAGGCG-1	True	True	True
GCTGCATCATTGTCCT-1	True	True	True
CATGCATAGTTAGAGG-1	True	True	True
CATAAGCTCTCAATTC-1	True	True	True
TCCTTCAAGTCATTAG-1	True	True	True
TACAAGCTCTCCTCAA-1	True	True	True
TATCGCGAGATAGACG-1	True	True	True
ATCAGGTTCTTGTTCG-1	True	True	True
CTCACTCAGCTTATGA-1	True	True	True
ACTTAGGGTTCCTCCT-1	True	True	True
CCTACTGGTATTGTGG-1	False	False	True
AGGACTAAGCATGGTT-1	False	True	True
CTAGCTGAGGCGCACT-1	True	True	True
ATAACGACAGGATGGC-1	True	True	True
GGTTCCCGTTGCCTCA-1	True	False	True
GTACCTTGTAGACAAA-1	True	True	True
ATCGAGGCAAAGCCTC-1	True	True	True
GCTTATCGTTGCATCT-1	True	True	True
AGTCGCATCGCTAAGT-1	True	True	True
CAGAATCTCAATACGC-1	False	False	True
GAAGGCCCAGGACCAA-1	True	True	True
TTTAGCAAGGAACGGT-1	True	True	True
CTTCATCCAATAACCT-1	True	True	True
GTTTGCTGTGTCCTGC-1	True	True	True
GGCCTAATCCAAGTTA-1	True	True	True
CTAACCCTCCGCAACA-1	False	True	True
TGTGCGGGTCTCAGCC-1	True	True	True
TTTCACCCATGTTGCA-1	True	True	True
CAATATGTCGATTATG-1	True	True	True
GTTTCAGCACAGGGAC-1	True	True	True
GAAGCCTGTTAGGTTG-1	True	True	True
TGGACGGAGGGTGAAC-1	True	True	True
GGATTTATCAACCAAC-1	True	False	True
CGGTAACGTAACGAGG-1	True	True	True
CGAAGTAAGGTCGAGG-1	True	True	True
GTGTGCGGTGTTGTAG-1	True	True	True
ACGCCTAAGGCATTGT-1	True	True	True
ATCAAGCTCCGGTATG-1	True	True	True
AAACGTACAAGATTCT-1	False	True	True
TGCATTAAGTGAACCT-1	True	True	True
GAACCTGTCGCCTGTT-1	True	True	True
GGTCGGTTCAAGTGAG-1	True	True	True
GCGCCTTGTTAAGTGT-1	True	True	True
CAAGTATGTTCGGTAA-1	True	True	True
TCCTGGTTCACGCCAA-1	True	True	True
AGCGGATAGCGAGGTG-1	True	True	True
AGCTAACTCACGCGGT-1	True	True	True
ATATGGTGTGGAAACG-1	True	True	True
TTTGACCGTTTATCTG-1	True	True	True
TGCTTCATCCGCCAAA-1	True	True	True
GTCCTAGAGGCATTGT-1	True	True	True
AAAGGTTAGGGATGCG-1	True	True	True
ACCTGTTGTAGCCATA-1	True	True	True
CAATCCCTCTTAATGG-1	True	True	True
CAACTAATCGCAAACT-1	True	True	True
ATAGATGCAGGATTAA-1	True	True	True
ATTGTGATCAGGGCCT-1	True	True	True
GGCAAGCCACGTTACA-1	False	True	True
CGCAATCCATGCTTAG-1	True	True	True
CTGTACCTCTGTAATG-1	True	True	True
AGTAATGCAACACCTA-1	True	True	True
GCTATTGCACCTACTT-1	True	True	True
CGAACCGGTAGACAAA-1	True	True	True
TGCTGGATCTTAGTCT-1	False	True	True
GCAGGAAGTTGAAGCC-1	True	True	True
GCCAACATCATGCTAA-1	False	True	True
GAGTTACTCCAGCACA-1	True	True	True
TACCAGGTCAGCTAAC-1	True	True	True
GTACCTTGTGACATGC-1	True	True	True
ATGGCCGGTAGCCTAA-1	True	False	True
TAACCGGTCCCTGTTA-1	True	True	True
CATAAGCTCAGGTCCA-1	True	True	True
TGCGCAGGTGAGACTC-1	True	True	True
CTAAAGCTCTTGCAGG-1	True	True	True
AGAATCGAGCTACTGG-1	True	True	True
CAATCGCCAGGCATCT-1	True	True	True
AGTTTGATCATGCGTG-1	True	True	True
TTGTCCGGTTTGCGCC-1	True	True	True
AGAATCGAGCAGCTCA-1	False	False	True
TGTAATGTCCTAAGGT-1	True	True	True
TGAACAACAGTTTCTC-1	True	True	True
GTGGACACATCCCGCT-1	True	True	True
GTCGGTTCAGCAACAG-1	False	True	True
ACTTTGTTCGCGACAC-1	True	True	True
GTGGATGCAAATGCCC-1	True	True	True
CGGACCTAGCGAGGTG-1	True	True	True
AATTGGACAGCCTGCA-1	True	True	True
CTGTATTTCATGGCTG-1	True	True	True
GAGGTACAGGGATGAC-1	True	True	True
AACTCACAGGATCCGC-1	False	True	True
GCGGTTGGTGTTGCAA-1	True	True	True
GGCTGGTTCCAACTGG-1	True	True	True
TCTTGACGTTCATCTA-1	True	True	True
AACCGGCTCTGGCTTC-1	False	True	False
GAAGTAAGTGAGGTGA-1	True	True	True
GTTCCTTCATCCATCT-1	True	True	True
AAGCAAGTCAAACCGT-1	True	True	True
AGGTTACTCTTGCATT-1	True	True	True
TGTTGTAAGCGATAGA-1	True	True	True
CTCATGACATTGCAGC-1	True	True	True
GCATATATCCTAATGA-1	True	True	True
GCGCTAGGTCCTTCTC-1	True	True	True
TTATTGCTCTAGCTAA-1	True	True	True
GTATCGCCAATTAGCT-1	True	True	True
GCCTTACTCGGCCATA-1	True	True	True
TCGATTAAGGGACCTC-1	True	True	True
TGCTCTCAGTTTGAGC-1	True	True	True
GTGCCTTTCTTAGGAC-1	True	True	True
GAACTTATCCTGAGTG-1	True	True	True
CGGTTATAGTTCCTCA-1	True	True	True
AATTGGACACTAAGCC-1	True	True	True
TACTGAGGTGATCAGC-1	True	True	True
ATTTAGCCAACACCTA-1	True	True	True
CTGGTTTGTTTGCTGT-1	True	True	True
CCGCCAACAGGTTTGC-1	True	False	True
AGCCTCCGTTGCTTCG-1	True	True	True
CCGTTGCGTGAAACAA-1	True	True	True
AATCGCCCATTAAGCT-1	False	True	True
CCTCAGTTCAGCCAAT-1	True	True	True
CATAACGGTGCTAGCG-1	True	True	True
AGCATTTCAGGACCTT-1	True	True	True
CGCTGTGCAGCTAATT-1	False	True	True
ATGAAGCCAGGTCCTG-1	True	True	True
TTAGCAGGTCTCAGCC-1	True	True	True
AACAGGATCTGGTCCT-1	True	True	True
CTCATGCTCCCTGACT-1	True	True	True
TGGCTATAGGCCTGGT-1	True	True	True
CAATCTAAGACAACGA-1	True	True	True
TGCTCTCAGGCTAATC-1	True	True	True
GGTTCCCGTAGACAAA-1	True	True	True
ATTGCGCCATTTGCTC-1	True	True	True
CGTTAACAGAATGACG-1	False	True	True
TATCGAGGTCCTTTAA-1	True	True	True
TGTGTTAAGGTCAAAG-1	True	True	True
TATGGTCAGATAGACG-1	True	True	True
CTCAGGATCTGGCATG-1	False	False	True
AGCGCTCAGTCATTGA-1	False	True	True
CCTCCTGAGGTGCGGA-1	True	True	True
AGACTATGTTTCCACG-1	True	True	True
CCAACATAGCATTAGC-1	False	True	True
GCAAACTTCCTGATGG-1	True	True	True
TCGTTAAAGGAACCGG-1	True	True	True
GCCACTAAGTCTATGA-1	False	True	True
GAGGCAAGTTGACTTC-1	True	True	True
TTTAACCTCCGCCTCA-1	True	True	True
TTTAGGATCATGAAGG-1	True	True	True
TCTATGTTCGCAAACT-1	True	True	True
AATTGGACAATCCTGA-1	True	True	True
AGGTCATTCCCGTTGT-1	True	True	True
CAACAATGTCACCAAA-1	True	True	True
GCTCCTTAGCTTAACA-1	True	True	True
CTACTAAAGCAACATC-1	True	True	True
AAGCCTCCAAGTGAAC-1	True	True	True
TTGACATCAACACCTA-1	True	True	True
ATCACCCTCCTACCTA-1	True	True	True
CGCCAAATCACGCCAA-1	True	True	True
GACTATTCAAACCTTG-1	True	True	True
CTAAGTCAGCCGCTAA-1	True	True	True
CCGTTATGTACTGAAT-1	True	True	True
GCGCTTAAGGGTGGAT-1	True	True	True
ATTATCCTCCCTCAAC-1	False	True	True
ATAATGGCATGACTAT-1	True	True	True
GCTGATCCAGTATGTT-1	True	True	True
TGATCCTGTGATGAGG-1	True	False	True
TCGGTTTGTTAACACG-1	False	True	True
AGACAATAGGTGAGAC-1	False	True	True
GCTTGACCATGAGTTT-1	True	True	True
TCTTCAAGTCCTAATC-1	True	True	True
AGGTAACCATAGGCGA-1	True	True	True
CGGGTCTAGCAGCTCA-1	True	True	True
TCGGTTTGTCAATGTG-1	False	True	True
GGAAACTCAATAGCAA-1	True	True	True
GGTCAAGCAATTATGC-1	True	False	True
CTTTGTCCAGGACACA-1	True	True	True
CCCATAACAGTAGCCT-1	False	False	True
TGTGCTGAGGTTAGAG-1	True	True	True
CTTATGTTCCATAAGC-1	True	True	True
TTGTCCATCCCGTTAC-1	True	True	True
GGCGATACAGATTCAT-1	True	True	True
CCATAATCATAACGGG-1	True	True	True
ATTGCGCCAGGACACA-1	True	True	True
TCCGCCATCCTCCATA-1	True	True	True
ACCACATAGTCATCCC-1	True	True	True
GATGCTTAGCAGGCCT-1	True	True	True
AGTTGTCAGTAGGCGG-1	True	True	True
TGGCTTTGTGTGCACG-1	True	False	False
CCTCAAACATGGCCTG-1	True	True	True
TGAGCCGGTTACAACG-1	False	True	True
CGCATTACAGCCTTGG-1	False	True	True
GAGCGAAGTCAAAGGG-1	False	True	True
TTGCTTAGTGTCACGG-1	True	True	True
CAATGCCCAGGTTAAA-1	True	True	True
AATGAAGGTAGGTTGC-1	True	True	True
CACAGGCTCATGCTTT-1	True	True	True
AAGTTAGCATATAACC-1	True	True	True
CATGGATTCCCTTGCG-1	True	True	True
ACGAATCTCAATGTGC-1	True	True	True
GCCGTGAGTTCGCTTG-1	True	True	True
GTCATTAAGTAACGAG-1	True	True	True
GTTACTCGTTGCGCGA-1	True	True	True
GCATTAGGTTAGGACC-1	True	True	True
CAGCCTTTCCAAACAC-1	True	True	True
ACGCTTGAGGTAGCTT-1	True	True	True
CATCCTCAGTTATTCC-1	True	True	True
GTTACAGGTTAAGCTG-1	False	False	False
ATGGCTGTCTAGCTAA-1	True	True	True
CTAGCTGAGCCGCTTT-1	True	True	True
TACGCTTGTAGTAAGA-1	True	True	True
AAGCTAGAGCTCATAA-1	True	True	True
CTATGAGGTAGTTAAC-1	True	True	True
GGGAATATCCCTCAGT-1	True	True	True
TTTGACTTCGATATTG-1	True	True	True
AAAGCCCGTGGGTACT-1	True	True	True
TTGACATCATGAAGTA-1	True	True	True
AAACGCGCAGTAGGTG-1	True	True	True
ATGTTTGAGCACAGAA-1	True	True	True
ACGCCTAAGAAAGGAA-1	True	True	True
GAGCCACTCTTAGTGA-1	True	True	True
GATAAAGGTCACCTAT-1	False	True	True
CCCGTTGTCTTTAAGG-1	True	True	True
TTTGTCCCAGCAACCT-1	True	True	True
GGAAGCTAGGATCACT-1	True	True	True
ATTAGTCCACATAACT-1	True	True	True
CTTCTCAAGACAACAG-1	True	True	True
GCAGGTTGTTGCGGAT-1	True	True	True
TTTAGCAAGGTTACAC-1	True	True	True
TCTCACCAGGAGCAAC-1	True	True	True
TAGCCTCTCGGCCAGT-1	True	True	True
GAGCGATAGATAGACG-1	True	True	True
CCATAGCCAGGCCTTG-1	True	True	True
AGATGAAGTCCTTTAA-1	True	True	True
ACGCTTGAGGTCGAGG-1	True	True	True
GCCTCAAAGTAAGGGC-1	True	True	True
AAGCTTGGTTTAGCTC-1	True	True	True
TACCGCAAGCCAAATC-1	False	True	True
CCAACATAGAACCTAC-1	True	True	True
GTCGCAATCGGTTCCT-1	True	True	True
AGCGGACCACTGACCG-1	True	True	True
GAGGCCTTCAATGTGC-1	True	True	True
TGTTGTTTCAAGTGAG-1	True	True	True
CTAGTAGGTCCCGAAG-1	True	True	True
GCAGGAAGTTGTTGTC-1	True	True	True
CCCAATTGTTATTGCC-1	True	True	True
CAAGTATGTACGCGCA-1	True	True	True
GGTTACCCAATGCGCT-1	True	True	True
ATTGCGCCACTTGTTC-1	True	True	True
GTGCGCAGTCGTAAAT-1	True	True	True
GGTCTTTGTTTACTTG-1	True	True	True
AAGCCTGTCTTGACCC-1	True	True	True
ATGGCTAGTTACAAAC-1	True	True	True
AATTTCCTCCTAGTAA-1	True	True	True
GTTAACGGTTTACGTC-1	True	True	True
GATCGAGCATGGTTAT-1	True	True	True
AGCAATACAACATAAG-1	False	False	True
GGAAACTCATAATGTC-1	True	True	True
CAATGCCCACCTACGG-1	False	False	True
TGATCCTGTAATGGCC-1	False	True	True
GTTGCTGAGGAACGCG-1	True	True	True
CCGCTTAGTACTGAAT-1	True	False	True
ATCACCCTCGTGCTTC-1	True	True	True
ACGAACAAGGCCATCA-1	True	True	True
TGCTATGCAAGGTCGA-1	True	True	True
CAAACACTCTCGACCT-1	True	True	True
TTTGACTTCACAAGCT-1	True	True	True
TTACCTGTCGGCTAGC-1	True	False	True
ACTTGTCGTGGACATC-1	False	True	True
AAACGCGCATGACTAT-1	True	True	True
AAGGCCCTCGTGCCTT-1	True	True	True
CAGTATGGTCTAACCT-1	True	True	True
AGCAATACAACTAGGG-1	True	True	True
CTGTTCATCAAGACTC-1	True	False	True
AGGCAATCAACAACAA-1	True	True	True
AATTTGCCACTTAACG-1	True	True	True
CAAACACTCACTAGGT-1	True	True	True
GACCTTTGTTAACGAT-1	True	True	True
TTGTAAGTCATCCTGC-1	True	True	True
CGTGTTACATGTTGTG-1	True	True	True
GGTGTTGTCGATCAGT-1	True	True	True
GGTATTGGTTCACCCA-1	True	True	True
GGCATTGTCGTACCGA-1	False	True	True
ATGTTCAAGGACCTGC-1	True	True	True
GATTGCAGTTCAAGCA-1	True	True	True
TTCCCGCCAAAGCTAA-1	True	True	True
TGTATCGCAGCAACCT-1	True	True	True
AATGCATGTGATGAGG-1	True	True	True
TCAAGCTAGGACGTAA-1	True	True	True
ACGCCACAGTTATGTG-1	True	True	True
TTCGGTACAATAACCT-1	True	True	True
TTACCGTGTGAATCGC-1	True	True	True
TCCCTGGTCTGTGCAG-1	True	True	True
GACTATTCACAAAGCG-1	True	True	True
CAACTAGGTTTGAGGC-1	True	True	True
ATTAGCTCAGTAATAG-1	True	True	True
AATAGCTGTACTAAAC-1	False	False	True
GCACTAAGTAATTAGC-1	True	True	True
CATAATCCAGCTACGT-1	True	True	True
AGTGCACGTTGCGGAT-1	True	True	True
AGTGATGAGGAATAAC-1	True	True	True
TATCGAGGTCCCGAAG-1	True	True	True
GAAGCCTGTTGAGCCG-1	True	True	True
GCTTACCTCAAGTGTC-1	True	True	True
TAGCCTCTCCCTCAAC-1	True	True	True
GTGCTGGGTTCATTTG-1	True	True	True
CTTAATGAGCCTGACA-1	True	True	True
AGGGTTGCACAAGCCT-1	True	True	True
GGTGAGCCAAGGTACG-1	True	True	True
TTGGATTCACACTAAT-1	True	True	True
AAATGGCCACCTCAGG-1	True	True	True
CTTCATCCACACTAAT-1	True	True	True
TGAGTGAAGTGTTGTA-1	True	True	True
ACCACACCAATGCCCG-1	True	True	True
CATAAGCTCGCACACA-1	True	True	True
GCCTTACTCTCGACCT-1	True	True	True
GCGGAACCATCGCTTT-1	True	True	True
GCTCCTTAGTTATCCT-1	True	True	True
ACTGAAACAGTAAAGC-1	True	True	True
TTGTAAGTCTTGAGGT-1	True	True	True
CCGGTTAAGGCATGTT-1	False	True	True
GCGGATACACAGAAAC-1	False	False	True
TTGTGCCTCCAAACAC-1	False	True	True
CAGCTAAGTTGTGACA-1	True	True	True
CAATGCCCACTTAGGC-1	True	True	True
TTCTTAGGTAAGCTCA-1	True	True	True
GCTGGATGTTGGCGTG-1	True	True	True
GTGAGGAGTCTTGCAT-1	True	True	True
TGCTAACAGGTGCTGC-1	True	True	True
CTGTACCTCAAACACC-1	True	True	True
CAGGGCTTCGCTAGCA-1	True	True	True
TACCGCAAGGTCGAGG-1	True	True	True
TTAGGCCCAAGCGAGC-1	True	True	True
CGTGGTTCAGGAACTG-1	True	True	True
AAGCAAGTCCTGTTCA-1	True	True	True
AAGCCTCCAGCTAATT-1	True	True	True
CCTTATGTCAATCATG-1	True	True	True
GCGCTTAAGGATCACT-1	True	True	True
AAGTTTGTCCTTAGGG-1	True	True	True
ATTATCCTCCCGCCTA-1	True	True	True
GCACCTAAGAGCAAGC-1	False	True	True
CGCCTGTGTCACACCC-1	True	True	True
TGCACCTTCATCACTT-1	True	True	True
CATTCATTCAGGTCCA-1	True	True	True
TCTTGTCCAGGTCCTG-1	True	True	True
GCAGGCAAGGACAACA-1	True	True	True
AACCTAATCCTACCTA-1	True	True	True
AAGTGCAAGCAACATC-1	True	True	True
GCCAGGAAGGCTGTCA-1	True	True	True
AGGATATAGGGATGCG-1	True	True	True
GATGGACAGCTACTGG-1	True	True	True
GCTAGCGGTTCACCCA-1	False	True	True
AATAGAGGTTTCAGGA-1	True	True	True
AGCTTTAAGTAACCCG-1	True	True	True
GAGGCCTTCTCAATAG-1	False	True	True
GGATGTAAGGTCCACA-1	True	True	True
ACTTATGAGGGATTAG-1	True	True	True
GGTTCCCGTAGCCTCC-1	False	False	True
TTGACTAAGGACTTAC-1	True	True	True
GATGACTTCACAAGCT-1	True	True	True
GTGTGCGGTTAGGCGT-1	True	True	True
CCTGTATGTTTATCTG-1	True	True	True
GCACTTACATTATCCC-1	False	False	True
CTTGCATGTGGTTCTT-1	False	True	True
GCCTCAAAGTGCACGC-1	True	True	True
GTACTTCGTTAGGCGT-1	True	True	True
CTGTTAAAGCTCCCTG-1	True	True	True
TGGTTAATCTGTGAGT-1	True	True	True
GCAAACAAGGTGAAGC-1	True	True	True
TTTAACGAGCATTAGC-1	True	True	True
TCAATCGCACCTACGG-1	True	True	True
TAGCGGCTCCACCTTA-1	True	True	True
CCAAACTAGCCGCTTT-1	True	True	True
ACTGAAACAATGAAGC-1	True	True	True
CCAAACTAGGGCTAAA-1	True	True	True
TATCGCACAATGAGGT-1	False	True	True
CTCTATGTCTACCTGC-1	True	True	True
TTCAGGTAGTTACCGG-1	True	True	True
TCCAGCAAGTTAGCCG-1	True	True	True
TTGTGTGCAATAATGG-1	True	True	True
CCGCAAGGTATTTGGG-1	True	False	True
TCGTAATCAGCACGAA-1	True	True	True
AGATGCTTCTTAGTCT-1	True	True	True
CGGAGCAAGGTCAAAG-1	True	True	True
TGGCCAATCTAATTGG-1	True	True	True
ATCCACCTCGTAATCA-1	True	True	True
AAGGTGCAGTCACCAG-1	True	True	True
ACCAGGGAGCGAGCGA-1	True	True	True
ACGCCTAAGTAAACCC-1	True	True	True
CTTGCATGTTTGGCGG-1	True	True	True
TGGCCTTTCATTTGCT-1	True	True	True
CGCTTAACAGGCATGA-1	False	False	True
GGTCGGTTCATAAGCC-1	True	True	True
TTTCGTCCAATGCCCG-1	True	True	True
AATTACCCAGAATGAC-1	True	True	True
CCCGCTTCAACAGGTG-1	True	True	True
ATTACCGCATCGCTCC-1	True	True	True
GATTAGTGTTAGTGAT-1	True	True	True
CGTAACCCATAATCGT-1	True	True	True
CCATAATCATTGCGTA-1	False	True	True
AGTTACTCAGTTGCGT-1	True	True	True
CAGGGCTTCGATAACC-1	True	True	True
CCTGGTAAGCTTAACA-1	True	True	True
GTCTCACTCTAGCTTT-1	True	True	True
CTCGCTCCATTCAGCA-1	True	True	True
GATGACTTCCACCCTG-1	True	True	False
TAACCGGTCAATAGCC-1	True	True	True
TAAGCCAGTATTCGCT-1	True	True	True
CCACAATAGGTGTCCA-1	True	True	True
ATCCTTAGTTAAGTGT-1	True	True	True
TTTGTTGGTGAGAAAC-1	False	True	True
GTGCTCAAGTTTGGTA-1	True	True	True
GGTGCTTCAATATAGG-1	True	True	True
TGTGAAACACTGGCTG-1	False	True	True
TGGAACAAGCCTCTCG-1	True	True	True
CACGCTAAGTAACCCG-1	True	True	True
ACGAATCTCCTTGCAC-1	True	True	True
AGGTTACTCACAGCCA-1	True	True	True
GCCTATTGTGTGCAAC-1	True	True	True
GATGACTTCCGCACAA-1	True	True	True
CTGCTATGTATTCGCT-1	True	True	True
AGTTTGCAGTGTTGCG-1	True	True	True
ACTGAAACATGTTTGG-1	True	True	True
GACATAGAGCATGTTA-1	True	True	True
ATGACCAGTTGTCATC-1	True	True	True
AGGATTGAGGAACCGG-1	True	True	True
AGTAGGATCACACAGT-1	True	True	True
GGTTGACGTCCGCTGT-1	False	True	True
GGTCCGTAGGTGTTAC-1	False	True	True
ACATTGCAGCAATAGG-1	True	True	True
GCAATGTTCACCAATA-1	True	True	True
AGACACGCAGGAACAT-1	True	True	True
TATGGTCAGCAGGCCT-1	True	True	True
TGTGGCTCACCGGCTA-1	True	True	True
CCATTATTCCCATAAA-1	False	True	False
GTTACGCCAAGCCAGA-1	True	True	True
ACTCGCGCACGAATCC-1	True	True	True
CTGTAACAGTTGGCCA-1	True	True	True
TTTCCTGAGCAGGTTT-1	True	True	True
CGCTAATAGTGAGCGG-1	True	True	True
TGAGGGAGTGGACATC-1	True	True	True
AAGCTATGTACTGATG-1	True	True	True
GACCTAAGTTTGTCTA-1	True	True	True
CTGGCTTTCCAAACAC-1	True	False	False
CGGAGTCTCTCTAGCC-1	True	True	True
TATAGGTGTTATAGCG-1	True	True	True
TAGTGGCGTTAGTTGG-1	True	True	True
CATGGCGGTCATTACC-1	True	True	True
CACTTTGTCACTCAAA-1	True	True	True
CTAACCACAGTAAGTA-1	True	True	True
GCCCAAATCTTGACCC-1	True	True	True
CCAAGTTAGCCGGTAC-1	True	True	True
GTGCGCAGTGTTTGCT-1	True	True	True
AAACATGCAGCTAACC-1	False	True	True
GAAGTCAAGCTTCTCA-1	True	True	True
ATGAAGTAGTAAGTCC-1	True	False	True
CTTGCTCAGCTTAGCG-1	True	True	True
TGTTGGCCAGCATGGA-1	True	True	True
CGGGACAAGCGAGCGA-1	True	True	True
AGCTTGGTCAAGCTTA-1	False	True	True
TCGCGAGGTTGCAGTA-1	False	True	True
TCCTTGCAGAGCCGGA-1	True	True	True
TATTCGTTCACTCAAA-1	True	True	True
ATTCCTAGTAGGTTTG-1	True	True	True
CTCTAAGCAATTGAGA-1	True	True	True
CCGCAAGGTAACCAGC-1	False	False	True
CAATCGCCAAGGGTTG-1	True	True	True
CGGACAACAACTAGAA-1	True	True	True
AAGAACAGTCTTTATG-1	False	False	False
ACAGGTAAGTTTCCTG-1	True	True	True
GTCCTCCCAAGCTACC-1	True	True	True
CATGCGCAGAGCCGGA-1	True	True	True
CAAATCATCGATTTGA-1	True	True	True
GAAGTCAAGGACTAAG-1	False	False	True
CCACAATAGTCATCCC-1	True	True	True
GGTTGCATCCCGTTTA-1	True	True	True
TGTGGCTCAGTTATCG-1	True	True	True
GTCATGAGTCATTGTC-1	True	True	True
TTTAAGCCATAATGTC-1	True	True	True
CTAAAGCTCGAAGTAG-1	True	True	True
GTTAAGCTCTGTTCAT-1	True	True	True
CAGCTATAGCGAAGTA-1	True	True	True
GTTGCCCGTGCGCGTA-1	True	True	True
TGAGCACGTGGTTCTT-1	True	True	True
CGCACACAGTTTGGTA-1	True	True	True
CTTTATGGTGATCAGC-1	True	True	True
CAGCTAAGTACTGAAT-1	True	True	True
CCTGCTCCAAACTAAG-1	True	True	True
CCCAGCACATTGTGTG-1	True	True	True
AGCACTTAGCCTAACG-1	True	True	True
CCCTCAGTCCGCCAAA-1	True	True	True
GTTCCTGGTAATCGCA-1	True	True	True
TTCAACCGTTTAGTCC-1	True	False	True
AGAGAGGAGTAGGATG-1	True	True	True
CCTAGTTGTCACAGCG-1	False	True	True
ATCCTGACAATTTGGT-1	True	True	True
TAAGGCTTCCTGATGG-1	True	True	True
GCAATATGTTAGCATG-1	False	True	True
GTTCGCTTCAGGCTAT-1	False	True	True
CGATATTCAAACTCAT-1	True	True	True
ATGTCCACACAGGGAC-1	True	True	True
TGAGCAAAGGCACAGG-1	True	True	True
GCTCACAAGGATCACT-1	True	True	True
AACGCTAGTCACGGAT-1	True	True	True
GCAGGTTGTTAGTGAT-1	True	True	True
GTTAAGCTCGTTAGTA-1	True	True	True
GTTACCTGTTCATTTG-1	True	False	True
ACCAATATCAAGCTTA-1	True	True	True
TGCATCCTCCTTGCAC-1	True	True	True
CTACTTAGTGTTGTAG-1	True	True	True
ACAGGCTGTACCGAAC-1	True	True	True
ATACCGGTCCTTTACG-1	False	True	True
CTGGCTAAGCTTAACA-1	True	True	True
ATTCCTCCATCTTGAG-1	True	True	True
CCCTAATGTGTTCCCA-1	True	True	True
TAGTTGTCAGGCATGA-1	True	True	True
CAATAAGCAATCCCTT-1	True	True	True
GATTGATGTCAAAGAA-1	True	True	True
AGCGCTCAGCAATAGG-1	True	True	True
CGATTGAGTACCAGGT-1	True	True	True
TACCTTAGTATTGAGT-1	True	True	True
TGCATTAAGTTATGTG-1	True	True	True
TCTATGTTCCTGGTCT-1	True	True	True
CAGAATCTCTCCTCTT-1	True	True	True
AGGTTGCGTGCTGGTG-1	False	True	True
TTGTGTGCAAAGCCTC-1	False	False	True
TTTGGTGCAAGCTACC-1	True	True	True
GACCTGATCGCTAAAC-1	True	True	True
TCAGCCTTCTCACAAA-1	True	True	True
CAGCTATAGACAAGTG-1	True	True	True
CATGCGCAGAGAAGGG-1	True	True	True
GAGCCTTCACCCTCAC-1	True	True	True
TTGTCCATCCAATTAG-1	True	True	True
GGCTATGTCTCACAAA-1	True	False	False
TTGGCTACACACCAAC-1	True	True	True
ACAGCCGGTCTTGCAT-1	True	True	True
ACCTACCTCATAGACC-1	True	True	True
ATGAAGTAGCTACTGG-1	True	True	True
AGGAAACGTATTCGTC-1	True	True	True
GAACCAGCACTAAGAA-1	True	True	True
AGGCCCAGTTTGGCTT-1	False	True	True
TTGGGCCAGCAAACCT-1	True	True	True
CTAGCTGAGTTAACCA-1	True	True	True
GTCTTTGTCAGCTAAC-1	True	True	True
GGATTTATCGCGACAC-1	True	True	True
TTACACCGTCCTAACT-1	True	True	True
AATTCGTCAATATACC-1	True	True	True
TGTTGTGCAAAGCGGC-1	True	True	True
CTTAGTTTCATGGCTG-1	True	True	True
TGTTGTAAGTTAACCA-1	True	True	True
CATGGCGGTGTAATAC-1	True	True	True
TTGACTAAGAACCTGT-1	True	True	True
GCTAGCGGTAAATTGC-1	True	True	True
GCTGACCAGGTACCGC-1	True	True	True
TTGCACACAACTGGCT-1	True	True	True
TGAGGAGGTCATTACC-1	True	True	True
CGTTATTTCAGCAAAG-1	True	True	True
GTGCGCAGTGCTTTAC-1	True	True	True
CCTTATGTCTCGCCTG-1	True	True	True
ACGCCACAGTCAGGCC-1	True	True	True
CATTTGTTCCTTAAGA-1	True	True	True
AGGTAACCATGAATAG-1	True	True	True
CTAATCGCACTAAGAA-1	True	True	True
GGTTGACGTTTAACCC-1	True	True	True
AACTCACAGTAACCCG-1	True	True	True
GACTCACCAGTTAAAG-1	True	True	True
ACGAATCTCTAGCGAT-1	True	True	True
GAGTAATAGCAGGCCT-1	True	True	True
TGCTTAAAGTCAGGCC-1	False	True	True
CCATAGCCAGAAATTG-1	True	True	True
TTGAGGCGTCGCATAA-1	True	True	True
CTGTGTGAGAATCTCA-1	True	True	True
ACCAAGCGTAACGAGG-1	True	True	True
AGTTGGCGTTAGCAGC-1	True	True	True
TTCGTGCTCTAACTGA-1	True	True	True
TGAGTTTCATGCATAT-1	False	True	True
ATCACTAAGTATTGCA-1	True	True	True
GGCATTAGTTTGCAGA-1	True	True	True
TCCTGGTTCTGTGCCT-1	True	True	True
GCTAGCTCAGCACGTT-1	True	True	True
TACGCACCACTCGCTC-1	True	True	True
AGGATATAGCACAGCC-1	True	True	True
CGTGTGTCACTAAATC-1	False	True	True
CCATAAATCGCAGGCT-1	True	True	True
TCAAGACTCTCCATGC-1	True	True	True
ACTAACTCATTAAACC-1	True	True	True
TAGGAGGGTTACTTGC-1	True	True	True
CTAATCCGTAAGGTTT-1	True	True	True
ATGTCCACATCCAGGT-1	True	True	True
GGTTGCATCATGCGTG-1	True	True	True
TCGTTTCCACATACTG-1	True	True	True
ACCTTGTGTTCTTTAG-1	True	True	True
GTTTGTTTCCTAGTAA-1	True	True	True
CTTGCTCAGTTACTTC-1	False	False	True
CCGCTTAGTTAGACCA-1	True	True	True
TCAAGGTTCATGAGCT-1	True	True	True
AGAGGATGTTGTCATC-1	True	True	True
ATATGCTCATTTAAGC-1	True	True	True
ACTTGTCGTAATGACT-1	True	True	True
GCAAGTGCAAATGCCC-1	True	True	True
CGAAGGCCAACCTGGT-1	True	True	True
TGTGCGCAGATACTTG-1	True	False	True
AGCAGGTAGTTTGAGC-1	True	True	True
TGCCATTGTAGCTGCG-1	False	True	True
GATTCAATCTTACTCG-1	True	True	True
AGTTGGCGTGTCCTGC-1	True	True	True
TCGTTTCCACATAGCC-1	True	True	True
AACCGCTCACCAAAGG-1	True	True	True
AGCGTGCTCAAGCTAC-1	True	True	True
GGTACCGGTGAGAAAC-1	True	False	True
ATAGCATGTGGATTAT-1	True	True	True
TCAGTAATCCCTGTTA-1	True	True	True
AATGAAGGTCACCAAA-1	False	True	True
CGAGGTGAGCGCCTTT-1	True	True	True
CGTAACCCAGGACACA-1	False	True	True
AGACAATAGCCATCAG-1	False	True	True
CTCATGACATAATCAC-1	False	True	True
TATTTGCTCTGTAAGC-1	True	True	True
CGCTAACCAAGGTGCA-1	True	True	True
TTTGTGGCAACACTTG-1	True	True	True
CGCATTACATCACAGC-1	True	True	True
CGGATAAAGTTATTCC-1	True	True	True
CTCGACAAGTTTGCGG-1	True	True	True
GTGATGAAGTTGGATC-1	True	True	True
ACCTTCATCAACCAAC-1	True	True	True
TTATTGCTCTAATTGG-1	True	True	True
AATGCATGTCAATGTG-1	False	False	False
CTACGAAGTTGCAATG-1	True	True	True
CTTGCATGTTCTTTAG-1	True	True	True
TTTAGGATCCAGGAAA-1	True	True	True
GGCATTGTCCTGTTCA-1	True	True	True
TCCTCACAGTAACTCA-1	True	True	True
GTAGCGCTCCCAGTAG-1	True	True	True
ATCATCAAGTCACTAA-1	True	True	True
AGTAATCGTGCGCAAT-1	False	True	True
TCAGTAGGTGATGATT-1	False	True	True
TGCACACCAAGGTAAC-1	True	True	True
CATAGGCGTCTATCGT-1	True	True	True
CTCGTTATCAAGTGAG-1	True	True	True
GGATTTATCCTGATTT-1	False	True	True
ATTACCGCACATACTG-1	True	True	True
GCAAACTTCTCCATAT-1	True	True	True
CCGTTACTCGTAACGT-1	True	True	True
ATGGCCCAGCTCCTAC-1	True	True	True
GCCACAATCCTTGCGT-1	True	True	True
ACGGTACGTCGCATAA-1	False	False	True
TATTGACCAACTGGCT-1	True	True	True
ACTTGTCGTGCAATGC-1	False	True	True
GCTAACCCAGGAAGCC-1	True	True	True
CGCCTCATCACGAATC-1	True	True	True
GAAACTGAGCACAGGG-1	True	True	True
AGCGCTCAGTTACTTC-1	True	False	True
GCTCTGGCAGCCTGCA-1	True	True	True
GCTTCGCGTTGCCTCA-1	True	True	True
TAGTCAATCCATAATG-1	True	True	True
AATGCAACATGTTGCA-1	True	True	True
CGCGATTCAATGAATG-1	True	True	True
TTTCCGGGTCATAGAT-1	True	True	True
TCTTAGTTCATGGTGT-1	True	True	True
GTCCTAGAGCTGTAAC-1	True	True	True
AGTTGCGTCTTGGATA-1	True	True	True
ACGAAGTCAGGCAAGC-1	True	True	True
CCTTCGGTCCTCATGC-1	True	True	True
GTGGACACATCAGCAC-1	True	True	True
GGTCAAGCATCACTTC-1	True	True	True
GGCGGTTTCTCCATGC-1	True	True	True
CGTACGGGTTGGTTAG-1	True	True	True
CTTTGAGCAGGTTCAC-1	True	True	True
TTACAGCAGAGAGGCT-1	True	True	True
AGGCTAAAGGGCCATC-1	True	True	True
ACCACACCATGTCAGC-1	True	True	True
ATTAGGTGTTAAGCCA-1	True	True	True
GGTGCTGGTGTTTGCT-1	True	True	True
ACCTAAATCACCTGCT-1	True	False	True
GGTTGGTGTACTTAGG-1	True	True	True
TCAACAATCCCTGGAA-1	True	True	True
GTGTCCAAGCATGTTA-1	True	True	True
ACACTAGGTGTAACCA-1	True	True	True
AGGTTACTCGGGACTC-1	True	True	True
GTGTTACAGCATGTCG-1	True	True	True
ATTAGCTCAGGTTTGC-1	True	True	True
CGTTATTTCCTTAGGG-1	True	True	True
GGTAAACCATTGCGTA-1	True	True	True
GCCACTAAGGCGCACT-1	True	True	True
AGCAATACAAGGTCGA-1	False	False	True
ACACAATGTTCCTGTG-1	True	True	True
GGTTATATCCTTAATC-1	True	True	True
CGTGCTTTCCACCTTA-1	True	True	True
CAAGTTATCATAATCG-1	True	True	True
GGCGGTAAGAATCTCA-1	False	True	True
GGCGCTAGTGGACCTG-1	True	True	True
TTTGTGTTCGACCTGA-1	True	True	True
TTGCATTTCTAATCTC-1	True	True	True
CTATTACTCGATATTG-1	True	True	True
GCGAGTGAGTAACTCA-1	True	True	True
TAATTGCCAACAGCCT-1	True	True	True
TAATTGCCACGGTACT-1	True	True	True
CCTAAAGGTCGAAGTC-1	True	True	True
TGTTATGAGCACAGAA-1	True	True	True
CGATTGAGTACCGTTT-1	True	True	True
CTATGGCCACCGGTAT-1	True	True	True
CTATGATCATAGACCC-1	True	True	True
AAAGCACCATTTAAGC-1	True	True	True
TGTGTTAAGTTACTTC-1	True	True	True
GCCTTTATCTAACTGA-1	False	True	True
TCGACAAGTCAGGAAG-1	True	True	True
TCCTGTTCAGCCTTGG-1	False	True	True
ACGTTACAGGCGAAAC-1	True	True	True
GTCTTTGTCAGTTCCC-1	True	True	True
GTTGCTGAGATTGAGG-1	True	True	True
ACGTCCAAGGTTTGAC-1	True	True	True
GTGCACGGTCAAAGAA-1	True	True	True
AATATCCCAAGATTCT-1	True	True	True
GCCTTAACATGAAATG-1	False	True	True
GACGCCTAGCACGTTG-1	True	True	True
TCACATAAGGTGAAGC-1	True	True	True
TGTGCGGGTCATAACG-1	False	True	True
TAATGGACAGAAATGC-1	False	True	True
ATACCTGCAACATAAG-1	True	True	True
GGTGAGCCACAATACT-1	True	True	True
GTTCGCTTCCGGGACT-1	True	True	True
ATGGCTTAGTGTGATC-1	True	True	True
GTTCACCTCGGTTTGG-1	True	True	True
CTAATTGAGGTCTTGG-1	True	True	True
AGAACCGCATCATGTG-1	True	True	True
AATTAGGCATGCTTAG-1	True	True	True
AATAGAGGTACTTAGG-1	True	True	True
CTTACCTCAGTGAACG-1	True	True	True
CTTAAGGGTGTAACCA-1	True	True	True
CCAGGAACAGTTTACG-1	True	True	True
AAACGGATCACGAATC-1	True	True	True
AATGCATGTGGAAACG-1	True	True	True
TTATAGCCATGTTGGC-1	True	True	True
GAGAACCAGGATCACT-1	True	True	True
CAATGTCAGCTCCTTA-1	True	True	True
GAAGTATAGCACGATT-1	True	True	True
CCAGGATGTGGTTCTT-1	True	True	True
ACCTAAGGTCCTTCTC-1	False	False	True
GCAATGTTCGTGCTTC-1	True	True	True
ATGGTTATCGCTCCAT-1	True	True	True
GCGATTTAGCATGACT-1	True	True	True
CAGCATTAGCCGGTAC-1	True	True	True
AATCATGTCTGTTGCC-1	True	True	True
CATTCCTCACATAACT-1	True	True	True
TCCCGTTAGAACCTAC-1	True	True	True
TAGCGGCTCAAACACC-1	True	True	True
GATCAAGAGGTCTTGG-1	True	True	True
AATTTCCTCCCGCATT-1	True	True	True
GTTTAGCAGCGAGCGA-1	True	True	True
GCCTCAAAGTTAGTTG-1	True	True	True
AGGAGCTAGTATCGCG-1	True	True	True
AGTTTGATCCGCCAAA-1	True	True	True
TAGTCAATCCACCCTG-1	True	True	True
TGAAGCAAGACAAACG-1	True	True	True
GCCTAATAGAGGAGGA-1	True	True	True
GAGCATGCAGCCGCTA-1	True	True	True
GTCATTAAGTGAACCT-1	True	False	True
AAAGGCTCATTAAAGG-1	True	True	True
AGCTTCCTCGCCTAAG-1	True	True	True
CAAATCATCCTAGTCC-1	True	True	True
CTAAATGTCTCGCCCA-1	False	True	True
TCCGGAATCGAGGAAC-1	True	True	True
GGTTGCGGTTAACGAT-1	True	True	True
CGTAACCCACCAGGTT-1	True	True	True
GGATAACCACCTAAGC-1	True	True	True
ACATAGCTCCATAATG-1	True	True	True
GCCTTACTCCGTAAAC-1	True	True	True
ACACCTTGTACCGTTT-1	False	True	True
GCCATGATCAATTGGC-1	True	True	True
GGAACGGTCTTAGTCT-1	True	True	True
GCATTGCCACAGGAAT-1	True	True	True
GCTTCGCGTCCTTAGT-1	True	True	True
GATCACTAGGCTGTCA-1	True	True	True
GAGTGTTTCATTTGCT-1	True	True	True
CCTCAATGTACCGTTT-1	True	True	True
ATCCATAAGGAGCACG-1	True	True	True
CCTTCAGGTCAACAAT-1	False	False	False
CACCTGTTCAGGAACA-1	False	True	True
CAATAAGCATGCTATG-1	True	True	True
ATTGCAGGTCTCACTG-1	True	True	True
TAACCGGTCCTGGTCT-1	True	True	True
TTGGGTTAGTCCTTCA-1	True	True	True
CGAGTCGGTTACTTGC-1	True	True	True
CTAAGGTTCAAACACC-1	True	True	True
TCGTTAAAGCCGGTAC-1	True	True	True
CGTTAAATCCTCATGC-1	True	True	True
GAGCGGTCAAATACCT-1	False	True	True
TTTCCACCACTAAATC-1	True	True	True
CTGCTACTCCCTGGTT-1	True	True	True
TACCTTTAGGCTGGCT-1	True	False	True
AGCAAATAGTGACCTG-1	True	True	True
TTTCATCAGTTTGTCT-1	True	True	True
AGTTGCAGTCTTTATG-1	False	True	True
AAATGGCCATTGTCCT-1	False	False	True
GTGCAAGCATAGCTGC-1	True	True	True
ATCATCAAGGCTATGT-1	True	True	True
AATTGTGTCGTTAAGC-1	True	True	True
TGATCAGGTTCGCTCA-1	True	True	True
ATGAAGTAGAACAAGT-1	True	True	True
GGATACTTCGACCTGA-1	True	True	True
GTGATGAAGGGTGAGT-1	True	True	True
ACTTCGCTCTAACCTT-1	True	True	True
TGTCCTTCAGTCTATG-1	True	True	True
GCTCTGGCAATAATGG-1	True	True	True
ATTACTGAGGATTTGC-1	True	True	True
CGACAAGCAAACGGGC-1	True	True	True
TCAATCGCATTAAGTC-1	True	True	True
CCCAATTGTTTCCTCC-1	True	True	True
TGTGGCTCATACTCCT-1	False	False	False
GACCTAGTCGGTCATG-1	True	True	True
CCAGCTAAGCCTCTGT-1	True	True	True
ACCAAGCGTTACAAAC-1	True	True	True
GCCTAATAGGTTAGCT-1	True	True	True
TGTTGTTTCCCGCATT-1	True	True	True
GATTGATGTAAGTCGC-1	True	True	True
TTAGCGGTCGCAAACT-1	True	True	True
GCACGCTAGCCTGACA-1	True	True	True
GGTCGGTTCTGTGCAG-1	True	True	True
CTTCAATTCTCGCCCA-1	False	False	True
ACCAAGCGTTATGTGG-1	True	True	True
CTTTGTCCACACTAAT-1	True	True	True
AAGGATGTCAATTGGC-1	True	True	True
TTGGCTACAGTAAAGC-1	True	True	True
GTTCGCTTCTAATTGG-1	True	True	True
CAATGTGGTCTTTATG-1	True	True	True
GCGCTTAAGCAGCTCA-1	True	True	True
CGCATATAGTTCCCAC-1	True	True	True
GAGCGAAGTAACCACA-1	True	True	True
GTATGTTCAAAGCTCC-1	True	True	True
TCCTAGTGTCTCAGCC-1	True	True	True
ATGGCCGGTCACGGAT-1	False	False	True
CAACCCTTCCTAATAG-1	True	True	True
ACACTTGCAATATAGG-1	True	True	True
CATTGCGAGTTTGGTA-1	True	True	True
ACTTTGTTCCGCCTCA-1	True	True	True
GGGCCTAGTTTGGGTA-1	True	True	True
AGTTGTCAGGAGCATA-1	True	True	True
CAGGACCTCAATACGC-1	False	False	True
ATCTATGAGCACTTGG-1	True	True	True
TACGTACAGGTGAGAC-1	True	True	True
AAGGAAGCACTTCACT-1	True	True	True
TTGTAAGTCAATCTAG-1	True	True	True
TCTAACCGTTCCTCCT-1	True	True	True
AGTCAGGCATGTTTGG-1	True	True	True
AATGAAGGTGAGGTAG-1	True	True	True
ACTTGAATCATGCTAA-1	True	True	True
GAGGCCTTCCGCCAAA-1	True	True	True
CGGTTTCTCTGCAACG-1	False	True	True
CGCAATCCAATTAGGA-1	True	True	True
TGGTTAATCGCAATCG-1	False	False	True
TTTGTCCCACTAAGTT-1	True	True	True
CTGAATATCCGTAAAC-1	True	True	True
CAGGTCCAGTTCCCGT-1	True	True	True
GCAGGATAGTGAAGTG-1	True	False	True
CTCCAACTCGCTAGTG-1	True	True	True
GGCTATTAGTAGCTTA-1	True	True	True
TCTTGTCCAACTGGCT-1	True	True	True
GTGTGCGGTACAAAGA-1	True	True	True
ACTAATCCAGTAGCCT-1	True	True	True
AGTGCCGGTGCGCGTA-1	True	True	True
CATAACGGTTGAGGTC-1	True	True	True
CAAGTTATCTAGCGTG-1	True	True	True
CATCATAAGCACAGCC-1	True	True	True
GTTTCCTCATTATGGT-1	False	True	True
AAAGCCCGTAGGTTAT-1	True	True	True
AAGACATAGAAAGGAA-1	True	True	True
AAGTGCAAGCTGAGGG-1	True	True	True
ACGTTGTAGCCGCTAA-1	True	True	True
GGTATGTTCGGCTATG-1	False	True	True
TCTTAGTTCAGGCTAT-1	True	True	True
CTCGCTCCATGGCCCA-1	True	True	True
TTAAGCCAGTTAACCA-1	True	True	True
TCATTACTCCACCCTG-1	False	True	True
GTAGTTATCGGTTCCT-1	True	True	True
CTTTGAGCAACAGCCT-1	True	True	True
ACTCACTGTTACGCGG-1	True	True	True
GAAGGATGTGTGAGGA-1	True	True	True
ATCATCAAGTTTGTCT-1	False	True	True
CTGGTTTGTTTATGGG-1	True	True	True
CATCATAAGAAAGGAA-1	True	True	True
GGTCAGGAGTCACGAT-1	True	True	True
AGACCCGGTAAATTGC-1	True	True	True
GGCAAATCACATAACT-1	True	True	True
ATTCCTCCAATCGCAC-1	True	True	True
AAAGCAAGTAATGGCC-1	False	True	True
CCAGCTGCATAAACCT-1	True	True	True
GCCAATAGTTATGTGG-1	True	True	True
AGGACGTAGGTTTGCG-1	True	True	True
CGCTTGCGTCATGCAA-1	True	True	True
GACTCACCAGCCTTGG-1	False	True	True
GTTGCATAGGGTGAGT-1	True	True	True
CTCATGACATTAGGCC-1	True	True	True
AGCACTAGTTTCCTCC-1	True	True	True
TTCCTTGAGCACTAAC-1	True	True	True
CCTGGTAAGAGCAAGC-1	False	True	True
GTGCGGTTCATGCAAC-1	True	True	True
CACATAATCCCGAAGC-1	True	True	True
TGTTGCACATTGTCCT-1	True	True	True
CCATAATCAAGGGTTG-1	True	True	True
CGCTTAACAAGCGATG-1	True	True	True
GGGCATGAGGAGCACG-1	True	True	True
GTTCCTTCATGTCAGC-1	True	True	True
AGAGGATGTGTCCAGG-1	True	True	True
GAGCCACTCATGCTAA-1	False	True	True
GGTACCGGTTAATGAC-1	True	True	True
CAGCAAGCAGAACCGA-1	True	True	False
GACGTAAAGCAAGATG-1	True	True	True
TAGCCGGGTGCCGCAA-1	False	True	True
CAGCTAAGTTCCATTA-1	True	True	True
CAAACTGGTGGAAGGC-1	True	True	True
GGATGTAAGTAACCCG-1	True	True	True
GTAGGCGAGCAAGACA-1	True	True	True
GGGTTTGTCTAACCTT-1	True	True	True
GTATGTGGTACCGGAT-1	False	True	True
TAAGTAGCACCTACGG-1	False	False	False
GGTACTTAGATAACCC-1	False	True	True
AGCAACAAGTAACGAG-1	True	True	True
CCAAGGCTCCCGCAAA-1	False	True	True
GGACGAAGTATTTGGG-1	False	True	True
GCTAGCGGTGAGCACT-1	True	True	True
CACGCTAAGCCTGTTC-1	True	True	True
TCGTTAAAGGCTAATC-1	True	True	True
TGTGGCGGTCAAGTGC-1	True	True	True
TGTAACTCAAGGTACG-1	True	True	True
GATGGCTGTACCAGGT-1	True	True	True
AATTGACGTAACAGGG-1	True	True	True
GTGCCTTTCCAAGTGT-1	True	True	True
ATCATCAAGCTATTGA-1	True	True	True
GTATTGATCATGGCTG-1	False	True	True
ACTTGCACAATAGCCC-1	True	True	True
CCACACAAGGCGCACT-1	True	True	True
GAAAGGCTCCGTAAAC-1	False	True	True
CTTAGTTTCCTTGCAC-1	False	False	True
AGCTAAACACCCACAG-1	True	True	True
GACGCAACATAGACTT-1	True	True	True
AAGCGAGGTATTGTGG-1	False	True	True
GAGCGAAGTCCTTAGT-1	True	True	True
GCCTTAACAGTATGTT-1	True	True	True
CGTGCTGCACAAAGCG-1	True	True	True
CTATTGAAGCATCCAG-1	True	True	True
GTTCATTTCCTTGAGG-1	True	True	False
CACAATATCTCCTCTT-1	True	True	True
CTCTTGATCTTGTCCA-1	True	True	True
AAGGTATAGGACCTTG-1	True	True	True
AGTAATGCACGTTACA-1	True	True	True
TGAGGTGCAGATAGAC-1	True	True	True
GAAGGCTAGCACAGCC-1	True	True	True
GCGTAACGTACGCGCA-1	True	True	True
TGCTCTCAGCACTTGG-1	True	True	True
CTAATCTTCCACCTGT-1	True	True	True
GTTAGACTCGGCCATA-1	True	True	True
AGGATGTCATTATGCG-1	True	True	True
GAGGCTTGTGCATCGG-1	True	True	True
TTGGGTTAGAACAAGT-1	True	True	True
TTAGGATGTACCTTAC-1	False	True	True
GATTACTCAGTGAACG-1	True	True	True
GGTTTCTGTAATAACC-1	True	False	True
CGAAGAATCAATCTAG-1	True	True	True
GTTCATTTCCAATAGC-1	False	True	True
TCCTGTTCAATTAACC-1	True	True	True
AAACGGATCTAATCTC-1	True	True	True
TAGCTAATCTTGACCC-1	True	True	True
AGTGAACCATTGTGCA-1	True	True	True
CCCAGTTTCGATTTAG-1	True	True	True
TGTAAGCTCGCTAGCA-1	True	True	True
AAGCGCTGTTTATCTG-1	True	True	True
ACTCCTCAGTGAGGTA-1	True	True	True
CTTGGACCAAGCCACT-1	True	True	True
TTTAACCTCCTAAGGT-1	True	True	True
CTCTCACAGGCCTAAT-1	True	True	True
TGGGCCTAGCGGATTT-1	True	True	True
ACCCTGTTCATTAGTG-1	True	True	True
ATGTAAGCAGCCTAAC-1	False	True	True
ACTTGTCGTTTATTCG-1	True	True	True
AACTCACAGCCTGTTC-1	True	True	True
CGCATATAGGGCCACT-1	True	True	True
TGCACTTGTGCTTTAC-1	True	True	True
GGTACTTAGCCGCTTT-1	True	True	True
CAAGTGAAGTTTGCGG-1	True	True	True
TGGTCAGTCTGGTCCT-1	True	True	True
GCCTCGACAGCTACGT-1	True	True	True
GCCCTCATCGAAGTGA-1	True	True	True
CGCACCACACTTCACT-1	True	True	True
GGAAGCTAGCTACTGG-1	True	True	True
TGGTCAAGTGCATTAG-1	True	True	True
GTATTGATCCCTCATA-1	False	False	True
TGATCAATCGATTCTT-1	True	True	True
CCGTGCTGTTCTTTAG-1	True	True	True
GTTTATCTCACGTTAA-1	True	True	True
TGTTGTAAGGACCGCT-1	True	True	True
ATTGGCTAGCATTATG-1	True	True	True
AAGGTCAAGCGGATTT-1	True	True	True
GGACAGCCATATTGAC-1	True	True	True
TTCCCACAGGAACGCG-1	True	True	True
TACGGTTAGTTAGAGG-1	True	True	True
GATCGATTCCACCCTG-1	True	True	True
TAGCCTCTCTATCGCC-1	True	True	True
CCGGTTAAGCTATTAG-1	True	True	True
GAGAGGCGTGAGACTC-1	True	True	True
GGTAGGAGTTGGTTCT-1	True	True	True
GACATTATCCCGAAGC-1	True	False	True
CTACGAAGTATTACCC-1	True	True	True
TCAGCAAGTGATGAAA-1	True	True	True
TGATGAACATCGCTTT-1	False	True	True
GCCATGATCGATCAGT-1	True	True	True
GCGCTTAAGTCAGTAC-1	True	True	True
GTATCGCCACTCAACA-1	True	True	True
ACAGTATGTCCTTCAG-1	True	True	True
AAAGCCCGTTCCAGGG-1	True	True	True
GACTTACAGTTTGCGG-1	True	True	True
TTAGGCCCACAAAGCG-1	True	True	True
GCAAGTGCAAGCTTAT-1	True	True	True
AAGCCTTAGTTTGGGT-1	True	True	True
TTGGCTACACAGCCTG-1	True	True	True
GAAGGAACAACTAGAA-1	True	True	True
GCTCCTTAGTCCTTCA-1	True	True	True
TTTAACGAGTGATTCA-1	True	True	True
TGAGGCACAATTAGCT-1	True	True	True
CCTGTAACAGAAATGC-1	True	True	True
GCTGCAATCACCATTT-1	True	True	True
CACAATATCAATGACC-1	True	True	True
GTCAGGCTCGTTCACC-1	True	True	True
ATCCTGACAAGCGAGC-1	True	True	True
AAGCATGAGTGAGAGC-1	False	True	True
TTCCCACAGTTACCGG-1	True	False	True
TCATTTGGTGGGTACT-1	True	True	True
CGCCAAATCAATCTAG-1	True	True	True
ATCAATCCATAACGGG-1	True	True	True
TAGGCTGTCCAGGTCA-1	True	True	True
GTAAGCTTCATTGTTC-1	True	True	True
CATCCTGGTTTAGTCC-1	True	True	True
TGATCCTGTCATTAGG-1	False	True	True
ACCTTCCAGCAGCTAT-1	True	True	True
TGCTCAACATCCAGGT-1	True	True	True
GCCTTTGGTTTGGCTT-1	True	True	True
TACTTCGTCGGTTAGT-1	True	True	True
CGCTATGAGTCGCAAT-1	False	False	True
TGCGCAGGTCCTTCTC-1	True	True	True
GCCTCCATCTCTAGCC-1	True	True	True
CCAACCCGTAATAACC-1	True	True	True
CTTGCATGTTCCTGTG-1	True	True	True
GTTGGCCAGTTACTTC-1	False	False	True
TGCTCCGTCTGCAACG-1	False	True	True
TTAACTGAGGGACGCA-1	True	True	True
CAACTAGGTAGCTAAT-1	True	True	True
AGCCAGTGTTACAAAC-1	False	True	True
AACTAGTGTACAATGT-1	True	True	True
CAGCATGTCCTGCGAA-1	True	True	True
TTCTTAGGTTAGTGAT-1	True	True	True
CATAACGGTTAACGGC-1	True	True	True
TGGATTGGTCGTAAAT-1	True	True	True
ACTTGAATCGCTCACT-1	True	True	True
CCCTGTTAGTCATGCG-1	True	True	True
CCACAATAGCCTGGTA-1	True	True	True
GTTAGGCGTTACGCGG-1	True	True	True
TGCGATTAGTTTGAGC-1	True	True	True
AGTGCACGTCGTAATG-1	True	True	True
TCTACTAGTATTGAGT-1	True	True	True
CCTAATCGTAATAACC-1	False	True	True
TCGTTATTCGGCCAGT-1	True	True	True
GTGCTTACAGCTCATA-1	True	True	True
GGATAACCAAGACTCC-1	True	True	True
GGCCAACTCCCTCGCA-1	False	True	True
ACGCACGGTGGGAACA-1	True	True	True
CACAAGCGTAGGTTTG-1	True	True	True
GGATGTAAGTGAGCGG-1	True	True	True
GGCGTTATCGGCTATG-1	True	True	True
GTTCACCTCACAGCGC-1	True	True	True
GCCTGCTGTTTGGGTA-1	False	True	True
AGGTCTTAGAATCGCT-1	True	True	True
ACGCCTAAGTATCGCG-1	True	True	True
CCTAAGGTCACCTGCT-1	False	True	True
ATTACGTCACCTAAGC-1	True	True	True
TACTGGCCAAGGTGCA-1	True	True	True
AAGTGTTGTTAGTGAT-1	True	True	True
CTCCGTCCACCCTCAC-1	True	True	True
AAGTTTGTCCTAATTC-1	True	True	True
CCTTTAGTCGAGGTGG-1	True	True	True
ATCACCCTCCGCACAA-1	True	True	True
ATGCAGGCATTTGCTC-1	True	True	True
ATGAGCCGTTCGCGCT-1	True	True	True
TCTAACCGTGTTGCAA-1	True	True	True
TAGCCTTGTCATAAGT-1	True	True	True
CTCATGCTCTAATCCT-1	False	True	True
ATGGACAAGTCGCAAT-1	True	True	True
GCTAGTGTCGGTCAGC-1	True	True	True
GTACCTTGTTACAAAC-1	False	False	True
CCCTGTTAGCTATTGA-1	True	True	True
CTGTATTTCGCAAACT-1	True	True	True
CGAAATGAGTTAGTGC-1	False	True	True
TAGGTTATCGTAATCA-1	True	True	True
ATGCCTGAGATAAAGC-1	True	True	True
CAATCCCTCACAGCCA-1	True	True	True
TGATTGCAGTCTCACC-1	False	True	True
CGCTAACCAGCAATAA-1	True	True	True
GTACTTCGTTATCCGT-1	True	True	True
AGGACTAAGGCGCATC-1	True	True	True
ACCACATAGTAAGTGG-1	False	True	True
CACAGGGAGGAAGTAT-1	True	True	True
GGTGTTGTCCGCTAGA-1	True	True	True
GTTCCTTCAGCATTAT-1	True	True	True
CCGCCAACAATCGCAC-1	True	True	True
GTGTGCGGTTACCGGG-1	True	True	True
CCTAAATCAGAGGGAG-1	True	True	True
GAGCATGCATGAGTTT-1	True	True	True
CAATGTCAGGGTCTAT-1	True	True	True
TACTCAAAGCCACATG-1	True	True	True
CTAGCTTGTGAGACTC-1	True	True	True
GGGAATATCTATGACA-1	True	True	True
CCTTATGTCACACAGT-1	True	True	True
GAAGTGATCATCACTT-1	True	True	True
CTTTGTCCAAGTGTTT-1	True	True	True
GGTCATTAGGGATGAC-1	True	True	True
AAGCGTTTCATTGTCT-1	False	True	True
TGGTTGAGTTAAGGTT-1	True	True	True
AACCGCTCAGCTACGT-1	True	True	True
ACACAATGTAATGACT-1	True	True	True
CTAATAGTCGGTCAGC-1	True	True	True
TAACAAGCAAATACCT-1	True	True	True
ACCAGGCTCTAAGTCA-1	True	True	True
AGCAATACAATCGCAC-1	True	True	True
GCTCATTGTGGTTAGC-1	True	True	True
TTACACCGTGGGTGAA-1	True	True	True
TATCGAGGTTTGCAGA-1	True	True	True
AGGATGCAGGCCGGAA-1	True	True	True
CAAGTAACAGGCATCT-1	True	True	True
ATACCTGCATTATGCG-1	True	True	True
CGTAGCGGTCATTGAG-1	True	True	True
CTTTAGGCATGAATCT-1	True	True	True
ATGTCCACATCGCTCC-1	True	True	True
TCTAATCTCTAGCGAT-1	True	True	True
GGACCTCAGGGTGGAT-1	True	True	True
CTGGTAAGTTAGACCA-1	True	True	True
ACCAGGGAGCACGATT-1	True	True	True
TGTCATAAGTAGAGGC-1	False	True	True
GATTGCAGTCCTTCAG-1	True	True	True
ATCACACAGTTAGCTA-1	True	True	True
CAATCCCTCCTCACAC-1	True	True	True
TTTATGGAGGAACCAA-1	True	True	True
CCATAAATCCCTGGAA-1	True	True	True
TGGGCATGTACTTAGG-1	False	True	True
TCATTGCGTTAGCCAA-1	True	True	True
GAGCTAGCAGGCTAAG-1	True	True	True
GCAACAGCAAATTGCT-1	True	True	True
AGGTCATTCTTAGTCT-1	True	False	True
GGGCAATAGTCAATCA-1	False	True	True
GCAGGTTGTGATGAAA-1	True	True	True
CCTATATTCAGTATTG-1	False	True	True
CCCAATTGTAATCGCA-1	True	True	True
CTCCTGAGTCAACAAT-1	False	True	True
CTGCTCCCATATTGAC-1	True	True	True
GTTCTCATCCCGCATT-1	True	True	True
GGCAATCGTCCTTAGT-1	True	True	True
TGCATGAGTAACAGGG-1	False	True	True
ACTCACTGTGTTCCCA-1	True	True	True
TTGGCTTGTAACGTGC-1	True	True	True
GTACTAGGTAATGGAA-1	True	True	True
TTTAACCTCAGGATGA-1	True	True	True
CCTCCTGAGACAACAG-1	True	True	True
TGCCATTGTTCATCTA-1	True	True	True
GGCTAGTGTAATGGCC-1	True	True	True
AGCGCTCAGTTAGACC-1	True	True	True
GGTATTTCAATTGAAG-1	True	True	True
CGTGCTTTCCCTCAAC-1	True	True	True
GTGAACAAGTTAGCCG-1	True	True	True
TAGTGTGGTGGACATC-1	False	True	True
TAATGGACACAATACT-1	True	True	True
GATCGAGCATTGCGTA-1	False	True	True
GGCAATCGTGAGCGAA-1	True	True	True
GGTGTTGTCACTAATG-1	True	True	True
ACAACATGTGTTGCTT-1	False	True	True
ACCATTAAGTAAAGGT-1	True	True	True
GGGTATTTCATAACGC-1	True	True	True
CAAACAACACGTTACA-1	True	True	True
GTACTTAAGTCACTAA-1	True	True	True
TTGTCCCAGGCATTGT-1	True	True	True
TCAGGAGCAAGCTAAA-1	True	True	True
ACCAGGACATCCCTCA-1	True	True	True
AGTGAACCAGGATGGC-1	True	True	True
ACTTTGTTCTAACCTT-1	True	True	True
AGAAGGTGTTGCGCGA-1	True	True	True
GTCTAATCACCTCACC-1	True	True	True
ACCCAGGGTAATCGGC-1	True	True	True
ACTTACTTCCGGGACT-1	True	True	True
TTCCTTGAGCGGCTGT-1	True	True	True
GCCACTAAGAACCTAC-1	True	True	True
AGGATGTCACATTAAC-1	True	True	True
AGGTTAACAAGGTGCA-1	True	True	True
GATTGGCGTTAACGAT-1	True	True	True
AGAGATTAGTCAATCA-1	True	True	True
TACTGACAGTAGCCAT-1	True	True	True
CTTAAGGGTGCTCACC-1	True	True	True
CTATTGAAGGAACACA-1	True	True	True
TGAGGGCCATTTAAGC-1	True	True	True
CGCAATAGTTTCCTCC-1	True	True	True
TGGACGGAGCTTAACA-1	True	True	True
GTTTACCGTTTATCTG-1	True	True	True
AAGCTCCCAACAGGAT-1	True	True	True
GATCACTAGGAACGGT-1	True	True	True
GGAGTCTGTCACGGAT-1	False	False	True
GGAAGCTAGGAAGCAC-1	True	True	True
TATATCCTCCAGGAAA-1	True	True	True
GGATTCAGTTAGAGCC-1	False	False	True
TGATCAGGTGAGCAAG-1	True	True	True
AGCACTTAGGCTCATG-1	True	True	True
ATTCATGAGCCGCAGT-1	True	True	True
TGCTCACTCACAGCGC-1	True	True	True
TTTGGCTGTACGGGTT-1	False	True	True
GACCTAGTCCTTGAGG-1	True	True	True
CCCGTTGTCGATCAGT-1	True	True	True
TCAGGTTAGCCTGGTA-1	True	True	True
CAAAGCGCAAGCTACC-1	True	True	True
GCTAAGCGTTGCACGG-1	True	True	True
CGCTGTGCAGAAACGT-1	True	True	True
ACGTCCTTCCCGAACA-1	True	True	True
GTCTAGCCAATTGACT-1	True	True	True
ATGATGGAGCACAGCC-1	True	True	True
AAGTAGCCATTGTGCA-1	False	False	True
TCGTTACGTTTCCACG-1	False	False	True
GTCAGGCTCTTGAGCG-1	True	True	True
TTAGCGGTCGTCAAGT-1	True	True	True
AGCTTGGTCCCGCAAA-1	True	True	True
ATCAGGTTCCAGGAAA-1	True	True	True
AGTAACGAGCCTGATG-1	True	True	True
TGCACACCACAGCCTG-1	True	True	True
GCTCATTGTGTCCAGG-1	True	True	True
GGTCCTGCAATGCCTA-1	True	True	True
GAGTCAAAGTGAGAGC-1	True	True	True
CGGGTATGTGCGCGTA-1	True	True	True
TAATCACCACTAGCGT-1	True	True	True
GTCTATGCATAATGTC-1	False	True	True
AAGCATGAGGTGCTGC-1	True	True	True
GTCTAGCCACAATGCC-1	True	True	True
GTCCTCCCAGGATTAA-1	True	True	True
AAGCTTGGTTTGGGCG-1	True	True	True
GCGCTTGCATCCTGAA-1	True	True	True
ACCTAAATCTCGACCT-1	True	True	True
ATAAGCCTCGCTATGG-1	True	True	True
TACTAAGTCCTGAATA-1	False	True	True
GGTTAGCGTCATCCTG-1	True	True	False
GTATGTTCATCCTGAA-1	True	True	True
AGTATAGCAATATGGA-1	True	True	True
TCACCTCAGAGGCTAA-1	True	True	True
TTTCTCACAAATGCCC-1	True	True	True
ATGCGATTCCCGCCTA-1	True	True	True
TTTGCATTCGTGCTTC-1	True	True	True
CGAGTCGGTTCAAGAT-1	True	True	True
CCCTTAATCACGTTAA-1	True	True	True
GGTAACTTCGTTTCTG-1	True	True	True
AACCTTGCATGCTTAG-1	True	True	True
AATTGGGAGGCCTAAT-1	True	True	True
TGAGTGAAGTTTCCTG-1	True	True	True
TACGTTAAGATGCCTG-1	True	True	True
CTGCTATGTAAGTCGC-1	False	True	True
AACCTCACAATTGCGC-1	True	True	True
ATCACCCTCCCTGGTT-1	False	True	True
GGCGATACATCCCGCT-1	True	True	True
ATTACCGCAATTAAGG-1	True	True	True
GGAGGTTAGTTAGTTG-1	True	True	True
CATCAGCCACATGCTA-1	False	False	True
ATAAGTCGTCGTAAAT-1	True	True	True
GTTTGTCGTTAGTACG-1	True	True	True
TCATGAGGTCTTTGAC-1	True	True	True
CTCCGTCCAGCACGAA-1	True	True	True
GCCACAATCATTATGG-1	True	True	True
CTAGCTTGTTCATTTG-1	True	True	True
GACTTGGTCGTGCCTT-1	False	True	True
CGTGTTACAGCTACGT-1	False	True	True
CTTCAGGAGTTGCCTC-1	True	True	True
AGCTCATAGCGGTTAT-1	True	True	True
GCGCGATTCAGCAAAG-1	True	True	True
CTCTTGATCCAAACAC-1	True	True	True
TCACTGACATAGGCGA-1	True	True	True
CACTAGCCATTTAAGC-1	True	True	True
CAGCCAATCGAGGTGG-1	True	True	True
TCGCTAACATAAAGCA-1	True	True	True
GCTCATTGTGCATCGG-1	True	True	True
AGTTGGCGTTTAGCGA-1	True	True	True
GACTAATGTGTCCTGC-1	True	True	True
GAGGTGAGTCGCAATA-1	True	True	True
TGCTTCCAGGCTACTG-1	True	True	True
CTTTATGGTGCTTACT-1	False	True	True
TGCATTAAGTAGCTTA-1	True	True	True
TCAACAATCCTAGTCC-1	True	True	True
CGCTTACTCGTTAGCG-1	True	True	True
TCTTGTCCATTAAAGG-1	False	True	True
GCTGGTTCACTCAACA-1	True	True	True
GCTATAGGTGGTTCTT-1	True	True	True
CTTGACGAGATAAAGC-1	True	True	True
AGAGAAGCAAAGCTAA-1	True	True	True
AACAGCAAGGCTAATC-1	True	True	True
TGTAAAGCAGTAATAG-1	True	True	True
CACCTCAGTATTGAGT-1	True	True	True
TCAAGGAAGTCGCAAT-1	False	False	True
ATCAGGTTCCTGGTCT-1	True	True	True
CCAGCCTGTTCACCCA-1	True	True	True
ATCATCAAGTAACGGA-1	True	True	True
CAATAAGCATGGTTAT-1	True	True	True
CACCTCAGTGGTTAGC-1	True	True	True
AGTAAACAGGATCACT-1	True	True	True
GGGCATTGTTCCAGGG-1	True	True	True
CAAAGGATCGTACCGA-1	False	True	True
GCTTGTTGTTAGGATT-1	True	True	True
CGCCTCATCACGCCAA-1	True	True	True
CCCAAACCACCTCAGG-1	True	True	True
TCGGTAAGTAGTTGGC-1	True	True	True
AACGCCCAGTAACCAC-1	True	False	True
TCCATTGTCAAACCTA-1	False	True	True
CGAGGAAGTTAGAGGG-1	True	True	True
CCAAGGCTCGCATTAA-1	True	True	True
CTGTTGGAGATTGAGG-1	True	True	True
TTGTTGCGTTGGTTGA-1	True	True	True
GGTACTAGTACTTCAC-1	True	True	True
TGTGTTAAGCCTAATA-1	False	True	True
TACCGAAGTTCCGGGA-1	True	True	True
TCATACTTCTAGCTAA-1	True	True	True
CGCATATAGTCATTGA-1	True	False	True
CAATGTCAGGTCCAAT-1	True	True	True
ACACAATGTCCCGAAG-1	True	True	True
CTATTACTCTCTAGCC-1	True	True	True
GCTTTATTCAAGACTC-1	False	True	True
ACTCAGTAGTGGACAA-1	True	True	True
AGCCTAAGTCTAACCT-1	True	True	True
GAGCCTTCACCTGCCT-1	False	False	True
AGAGGATGTGGATTAT-1	True	True	True
CTAGTCGAGCATGCAT-1	True	True	True
AAGTTTGTCTACTAAG-1	True	True	True
AAGTGAAGTCTATCGT-1	True	True	True
ATCACAATCTCCATAT-1	True	True	True
CCGCTAAAGAACCTGT-1	True	True	True
CGTAATGGTTGCGCGA-1	True	True	True
TACAACATCACCTGTC-1	True	True	True
CGCTTCTAGTTGCCTC-1	True	True	True
GAACCTGTCATTTGTC-1	False	True	True
CTAGGACGTCTAACCT-1	True	True	True
CGCCTCATCATCCTGC-1	True	True	True
CCGTTGCGTAACCACA-1	True	True	True
TGTTCATTCATTCATC-1	True	True	True
TTCATCCCAAATGCCC-1	False	True	True
GGTTGCATCGGTTTCC-1	True	True	True
CACCGGTAGCTCCTAC-1	True	True	True
ATTACCGCAGCAAATA-1	True	True	True
AATTTCCTCGGCTAGC-1	True	True	True
AAACCGAAGTGCACGC-1	True	True	True
AATGAAGGTGGGTACT-1	False	True	True
AATATCCCAGCCTTGG-1	True	False	True
TTTGTGGCACCTAATG-1	True	True	True
TCTGGCTTCGCCTAAG-1	True	True	True
TTTCATCAGCTGGACC-1	True	True	True
GGTTCCCGTAATCCCT-1	False	True	True
TTTAGGATCAACCAAC-1	True	True	True
GTCTATGCATAGCTGC-1	True	True	True
GGCCAACTCGATTTAG-1	True	True	True
AGAATCGAGGTTACGT-1	True	True	True
CACTGACCAGGAATCG-1	True	True	True
GGTCTTGAGGAGTAAT-1	True	True	True
CTCCTGAGTGTGAGGA-1	False	True	True
AATTTGCCAGCAAGAT-1	True	True	True
CTAACCACACGTAAGG-1	True	True	True
GTAAGCAAGCCTGTGA-1	True	True	True
TACTCAAAGTAACGGA-1	True	True	True
ATCACAATCCGCCTCA-1	True	True	True
AACCGCTCATCCAGGT-1	True	True	True
GCTAGTGTCCCTGGAA-1	True	True	True
GAAACCCGTACGCGCA-1	True	True	True
AGTGGACAGTGAGCGG-1	True	True	True
GGTTCCCGTCTAACCT-1	True	True	True
GGCTGAGAGATACTTG-1	False	False	True
AGGTATTGTGCTAGCG-1	True	True	True
ATGGTTATCTAATTGG-1	True	True	True
AGGTTAGAGCAAACCT-1	True	True	True
ACACTAATCGATTATG-1	True	True	True
GCGCGATTCAATGACC-1	True	True	True
CCTGAATAGTTAGACC-1	True	True	True
CTGGTTACAGTATGTT-1	True	True	True
TCAGTAGGTCGTAATG-1	True	True	True
AGGCAATCAGGCTAAG-1	True	True	True
GCTTAAATCCTTAGGG-1	True	True	True
ATGTTCAAGAGGAGGA-1	True	True	True
TTACCGTGTGTCCAGG-1	True	True	True
TCTAGCCTCGCAGGCT-1	True	True	True
GGGTTATTCTGTTGCC-1	True	True	True
CCTTGTTCATCAATCG-1	False	True	True
GGTTCTTGTTGGATAT-1	True	True	True
GTTTGTTTCCCTTGCG-1	True	True	True
TTTGTTGGTTAATGCG-1	True	True	True
TGTAAGCTCCTAACGG-1	False	False	True
AGACTATGTTTGGGCG-1	False	True	True
GTTAGGCGTAGCCTCC-1	False	False	True
TGAGGCACATAGCTGC-1	True	True	True
CCAGGATGTTCCGCAC-1	True	True	True
CTTATTGGTAATCGGC-1	False	True	True
GACTAATGTAACGAGG-1	True	True	True
GGCGGTAAGCCGCTAA-1	True	True	True
TTGGAGGCAGGAACAT-1	True	True	True
TGATCAGGTAAGCACC-1	True	True	True
CAAGTGAAGCTTAACA-1	False	True	True
ATATGCTCAAACAACA-1	False	True	True
ATGGCTTAGAGCCGCT-1	True	True	True
GTATTCAAGGACCGCT-1	True	True	True
CCTAATCGTAAACAAG-1	False	False	True
CGGGCTTAGCATGAAG-1	True	True	True
AATATCCCATTTGCTC-1	True	True	True
ACTCAGTAGGCTACAT-1	True	True	True
TCCTTAGTCATTGCGG-1	False	True	True
TACTTCGTCTTAGTGA-1	True	True	True
AATCCATCATTGCGTA-1	True	True	True
TTTGTGAAGTAGCCAT-1	True	True	True
TGCGCGAGTGACATAT-1	True	True	True
TCAACAATCACAGCGC-1	True	True	True
GATAAGCCATCAGTAT-1	True	True	True
CTTACCGGTAGCTAAT-1	False	True	True
TAGTACGGTTATTGCC-1	True	True	True
CGTAGCGGTTAGGACC-1	False	False	False
CGAGGTGAGCTTCTCA-1	True	True	True
GGGTATTTCTCACATT-1	False	True	True
GGAGGTTAGGACCGCT-1	True	True	True
AGTTGGCGTGAGAAAC-1	False	True	True
TTGCCCGTCACTCGCT-1	True	True	True
CGGGTATGTTAGGCGT-1	True	True	True
CGGACAACACTAAGTT-1	True	True	True
GGATTATGTTTGCGAA-1	False	True	True
CGTTGCAAGTCACTCC-1	True	True	True
TACGTTAAGCTGTCAG-1	True	True	True
TTAGCTGCAAGCGAGC-1	True	True	True
ATATGCTCAAACTGCC-1	True	True	True
CACCTGTTCACACAGT-1	True	True	True
AGGTGAGGTTTGGTTC-1	True	True	True
CTTGTAAAGATGGAGC-1	True	True	True
GCAATCTAGCTGAGGG-1	True	True	True
TTCACTGTCAGTGAAG-1	True	True	True
GAGCTTGTCGTTAGCG-1	True	True	True
CCGCAAATCGTTCACC-1	True	True	True
TACTGCACAATATAGG-1	True	True	True
CGTAGTTAGGCTAATC-1	True	True	True
AGCGATTTCCCGTTGT-1	True	True	True
CTGTTGGAGGTCCGTA-1	True	True	True
CATAAGCTCCAACTGG-1	True	True	True
GTTTATCTCGTTTCTG-1	True	True	True
GGCCGTTAGCACAGCC-1	True	True	True
ATTTAGGTCAAGCTTA-1	False	True	True
CCACTTGGTCAAGTGC-1	True	True	True
GGTTGCGGTTGTGACA-1	True	True	True
AAGCTTGGTGTCCAGG-1	True	True	True
CGTGCTGCATCCAGGT-1	True	True	True
TGTTAGCAGGCGGATG-1	False	True	True
TTAGACTCAGGTTACC-1	False	True	True
GTGCTGATCGCACAAT-1	True	True	True
GTCGGTTCATGCAACC-1	True	True	True
ACGCTTGAGGGACTAA-1	True	True	True
CACAAGCGTCAACAAT-1	True	True	True
TCTTGTCCAGTTATGT-1	True	True	True
ATGACTCAGTCTGGGC-1	True	True	True
CAGGAAGGTCTTTGAC-1	True	True	True
ACAGTATGTGTTTGTC-1	True	True	True
GATAATCGTCAGGAAG-1	True	True	True
GTCTAACAGCTATGAC-1	True	True	True
TTTGAGTCACAATACT-1	False	True	True
GGTTACCCATTAAAGG-1	True	True	True
TCGCATTGTCTAACAG-1	True	True	True
GCAATGTTCGGGACTC-1	True	True	True
TAGCTTAAGGAACCGG-1	True	True	True
AGAGAGGAGTGGCGGA-1	True	True	True
GGAAACTCAGGCTAGA-1	True	True	True
AATTTGCCAGGCATGA-1	True	True	True
CATCCCAGTCTTACTA-1	True	True	True
ATGACGAAGGGATGAC-1	True	True	True
TAGCATATCCTAAGGT-1	True	True	True
GGTTAGCGTTAGGACC-1	True	True	True
CATAGACTCATGAGCT-1	True	True	True
CTTTATGGTTAGCATG-1	False	True	True
ATCAGGTTCGCAAACT-1	True	True	True
GATCAGGCAACAGCCT-1	True	True	True
GCAGGAAGTTCTTTAG-1	True	True	True
CTTTATGGTCGCAATA-1	False	True	True
GCGAAGTAGGTATTGC-1	True	True	True
TATCGAGGTTAAGCCA-1	True	True	True
CTATAACCATTCCTGT-1	True	True	True
GGAGCAAGTCCAAATG-1	False	False	True
TCACTGACAGGCCTTG-1	True	True	True
TCTGGCTTCATGCTTT-1	True	True	True
GCTAGCGGTACCGAAC-1	True	True	True
CAATGCCCACCTCGCT-1	False	False	True
CAGTACCCAATACTGT-1	True	True	True
ATGTTCAAGGTAGCTT-1	True	True	True
GGATTCAGTTGTCATC-1	True	True	True
CTCGACAAGCACTAGT-1	True	True	True
CAGGATGCAGTAGGAT-1	True	True	True
AGTTACTCACACCAAC-1	True	True	True
CTACAACAGGCCGGAA-1	True	True	True
TAGTTGTCATTATGGT-1	True	True	True
ATTCATGAGGATTGCT-1	True	True	True
TATAGCTCAGTAGGTG-1	True	True	True
CAAGTTATCCCTCACG-1	True	True	True
AGCACTAGTCCTTAGT-1	True	True	True
TGGGCCTAGCACGATT-1	True	True	True
GTAGTTTCAGCTAACC-1	True	True	True
CGTGCTGCACAACAAA-1	True	True	True
GGGTCACTCTGCAAAC-1	True	True	True
ACGCCTAAGTAGCTTA-1	True	True	True
AGTTATGTCGACAAAG-1	True	False	True
GGTTCTTGTTTAGTCC-1	False	True	True
CGCTCCATCCTACCTA-1	True	True	True
GTTCCCAGTAGCCTAA-1	True	True	True
CGTGAGGAGGGTCTAT-1	False	True	True
GGTTTGTAGTGAACCT-1	False	True	True
GACTTGGTCATTGCAA-1	True	True	True
TGGACGGAGCATTAGC-1	True	True	True
AATACCGGTTGCGGAT-1	True	True	True
ACGGTTTAGGAAACTG-1	False	True	True
CCTTATGTCCTCATGC-1	True	True	True
CGGATTAGTGCTTACT-1	True	False	True
CGCACACAGGTTTGCG-1	True	True	True
CCTCCTCTCTCACACC-1	True	True	True
TGCTCCGTCCCGCATT-1	True	True	True
AGACAATAGGGCTTAT-1	True	True	True
TTGACTAAGCGCCTTT-1	True	True	True
CCGGTTAAGGGATGCG-1	True	True	True
GCGAAGTAGTTAGGCT-1	True	True	True
TTTCAGTTCCGCCTAT-1	True	True	True
ACGTCCTTCAGTGAAG-1	True	True	True
ACAACACTCACTCGCT-1	True	False	True
ATAAGTCGTGCTTTAC-1	True	True	True
ACCTAAATCGCTATGG-1	True	True	True
CATTGCGAGCCGCTAA-1	True	True	True
GGAACGGTCGCTAAGT-1	True	True	True
TCCATCATCATTGACA-1	True	True	True
GATTCGCCAGCTACGT-1	True	True	True
GAGGCTACAAGGTAAC-1	True	True	True
ATTGAAGCATAGCGGA-1	True	True	True
TCCCGTTAGCGCAATT-1	True	True	True
TCTTAGCGTTTAGCGA-1	True	True	True
TGTCAATCAGCACGTT-1	True	True	True
TTGCACACATTCCTCG-1	True	True	True
GTCAGGCTCATGTCAA-1	True	True	True
TTTGCATTCAGCACGC-1	False	True	True
GGTTGCATCCAGCACA-1	True	True	True
GACATAGAGGCGCTTA-1	False	True	True
ACAGCCGGTGAAACAA-1	True	True	True
GGTCAAGCATGAGTTT-1	True	True	True
GTTCTCATCGTTTCTG-1	True	True	True
CATTATCTCATTTGCT-1	True	True	True
CGGCTCACAAGTTATC-1	True	True	True
GGTTTCTGTCAATACG-1	True	True	True
TAGTGGCGTGACCTGG-1	True	True	True
AGGTCTTAGTAACCCG-1	True	True	True
AGAACCGCAGGCTGTT-1	True	True	True
TGAGGAGGTCAGGCCA-1	True	True	True
GGTGTTGTCCCTCACG-1	True	True	True
TAGGCTTAGGACCTTG-1	True	True	True
CCGGTTAAGGACCTCA-1	True	True	True
AACCTTAAGCCTCTGT-1	True	True	True
AATTAGCGTCATAAGT-1	True	True	True
TCCATCATCAGGGCCT-1	True	True	True
TTGTTTGGTAGTAAGA-1	True	True	True
GATCAGTTCACTAAGC-1	True	True	True
ATGGTTATCGAAGTAG-1	True	True	True
GGCTTCAAGTCACCTC-1	True	True	True
CTGACATAGACACCGC-1	True	True	True
TCTTGACGTCCCGGAA-1	True	True	True
CCCAATTGTTAGAGCC-1	True	True	True
TGAGGTGCAGTTGCGT-1	True	True	True
TTCGGTACAACAGCCT-1	True	True	True
CTTAGTTTCGGGACCT-1	True	True	True
TGCATCCTCTCGACCT-1	False	True	True
ATGTTCAAGAGGAGTC-1	True	True	True
ATTCCTCCATTGTGTG-1	True	True	True
CGTTTCTCATAAGTTC-1	True	False	True
AGTCCTTGTGAAACAA-1	True	True	True
TGAGGAGGTCAAAGGG-1	True	True	True
CCTAGTTGTCCGCTGT-1	True	True	True
GTTAGACTCAATAGCC-1	False	True	True
AGTCAAGAGCTACTGG-1	True	True	True
CAGGACCTCGAAGTAG-1	True	True	True
TACTCAAAGCATGAAG-1	True	True	True
GATAATCGTGCTCACC-1	True	True	True
CGCACAATCACGCGGT-1	True	True	True
ATGAATGCATAGACTT-1	True	True	True
GTGTGTTAGCTAAGTC-1	True	True	True
GATTGCAGTGTGTCCC-1	True	True	True
CCGGTTAAGTAAAGGT-1	True	True	True
CGTTGCGCATTGCGAC-1	True	True	True
CATTGTGCAGCTAATT-1	True	True	True
GCAAGCCTCTACCTGC-1	True	True	True
TTTGTGGCACTGGCCA-1	True	True	True
ATGCAGGCAAAGGTAC-1	True	True	True
GTCCTCAGTGCTAGCG-1	True	True	True
CATTCATTCAATGTCA-1	True	True	True
TGGCCTTTCATCCTCA-1	True	True	True
CCTATTGTCACAGACT-1	True	True	True
ATTCATGAGGCATGTT-1	True	True	True
ACCTCACTCAAACCTA-1	True	True	True
CAGGTTAGTGTTAGCA-1	True	False	True
AGAATCTGTGAGACTC-1	True	True	True
TTATGACCAGGGAGCT-1	True	True	True
GGTTTAATCGTAACGT-1	True	True	True
AGCGCCTAGCGGATTT-1	True	True	True
TAAAGCCTCGATCAGT-1	True	True	True
CTATGTTTCTGCAAAC-1	True	True	True
ACTCGCGCATCCATCT-1	True	True	True
GTAGCGCTCTCCTCAA-1	True	True	True
CCTACTTCAAATATCC-1	True	True	True
CGATATTCAAGCTAAA-1	True	True	True
GGTCAATTCGGTAACT-1	True	True	True
GTATTGCAGTTCCCGT-1	True	True	True
TCTTGTCCAAACCTAT-1	True	True	True
ACATCATCAGCATGGA-1	True	True	True
GTGTTCCTCAGGATGA-1	True	True	True
TGGAACAAGCCTGGTA-1	True	True	True
GCTTATCGTCATAAGT-1	True	True	True
TAATGGACAAGTGTCC-1	True	True	True
TCAAGAACATAGACCC-1	True	True	True
TTTCTCACATGCAACC-1	True	True	True
ATAACGACATCCATCT-1	False	True	True
GACCGTTCATCTAGCA-1	True	True	True
GAGTTTGGTTGAAGCC-1	True	True	True
AGTAACGAGACTCGCA-1	True	True	True
CTTACCGGTGAACAAA-1	True	True	True
TCGTAATCAGGCATGA-1	True	True	True
GTTTAGCAGGATCCGC-1	True	True	True
AAGTGAAGTAAGCTCA-1	True	True	True
CACATTAAGTCTTGAA-1	True	True	True
TATGGATGTGGCTTCC-1	True	True	True
GACACCGGTTCCAGGG-1	True	True	True
CAGGATGCATCCTAGA-1	True	True	True
ATCACCCTCTTGAGCG-1	True	True	True
TGGGCATGTAACTACG-1	True	True	True
TAGGAACCATTAGCCA-1	False	True	True
GGTAAGGGTGATCAGC-1	True	True	True
ATCGAGGCAATCATGT-1	True	True	True
GCTTACCTCGTTAGCG-1	True	True	True
GAGGTAGGTTATCCGT-1	True	True	True
GTGAACAAGAAGCTAG-1	True	True	True
TTACACCGTTAAGCGC-1	True	True	True
GCGGAACCAAGTGTTT-1	True	True	True
ATTTGCAAGGATTTGC-1	False	True	True
GAACGAATCAGTTCCC-1	True	True	True
GGATGAATCGCTAGCA-1	True	True	True
GAGTTGCGTGGATTGC-1	True	True	True
ACCCTGTTCACGTTAA-1	True	True	True
AGTTACTCACCCACCT-1	False	False	True
CCTACTTCAAATTGCT-1	False	True	True
CCATAAGGTGGGAACA-1	True	True	True
GCTGTAAGTCACAGCG-1	True	True	True
CGACTAAGTTTGACCT-1	True	True	True
CTAGTCGAGGCTATGT-1	True	True	True
GCACGAACAGGCATCT-1	True	True	True
CCGATGCAGGTAAGGC-1	True	True	True
GCATGAGCAGGCAAGC-1	True	True	True
TGTGTGAGTGGGAACA-1	True	True	True
GGTGATTTCGGTTACG-1	True	True	True
GTGGACACACGGTACT-1	True	True	True
TCCATATTCTTGCAAA-1	True	True	True
AGGCAATCATTTAAGC-1	True	True	True
GCGCTAGGTGTCACGG-1	True	True	True
AGTGGACAGGACAACA-1	True	True	True
ACATTAGTCCCTGGTT-1	False	False	True
ACCCAACCAATTGAGA-1	True	True	True
TTGGCTGAGTTGTCCC-1	True	True	True
ACCGCAATCATGCTAA-1	True	True	True
GGCTCACAGTCTCACC-1	False	True	True
TCGTGCTTCAATACGC-1	True	True	True
AGTCTTGCAATGCCCG-1	True	True	True
TCCTCTAAGCTGTACG-1	True	True	True
CTTCAATTCCGCAAAT-1	True	True	True
GTTAAGCTCCCGCCTA-1	True	True	True
ATGACAACAGTATGTT-1	True	True	True
ACTAATCCAGCACCAT-1	True	True	True
TTTGTGGCATGATTGT-1	True	True	True
AATGTCATCTAGCGTG-1	True	True	True
AGAACCGCAAGCCAGA-1	False	True	True
TATGAAGCATGCAACC-1	True	True	True
CTTGCATGTTCGCTTG-1	True	True	True
CATCCTTCACCCTCAC-1	True	True	True
ACTTGCACACTGACCG-1	True	True	True
TTGCCCGTCACTAATG-1	True	True	True
TTCCTCAAGAGGGACT-1	True	True	True
CCGGTAGGTGAAACAA-1	True	True	True
TTAAGGACAGTAAGTA-1	True	True	True
CCTTATGTCTAAGTGC-1	False	True	True
TCCAGGTCATGAGCAG-1	True	True	True
GCTTTATTCTTACTCG-1	True	True	True
GATCGATTCCACCTTA-1	False	True	True
TAGCCTCTCAATTACG-1	True	True	True
CAGGTCCAGCGATAAG-1	True	True	True
TCTTGTCCATAGGCGA-1	False	True	True
CTCACAACAAACCTTG-1	True	True	True
AACCTTAAGAGGGACT-1	True	True	True
AATTGTGTCTTGATGA-1	True	True	True
TGCATCCTCATGCATA-1	True	True	True
ACAACAGAGGGTCTAT-1	True	True	True
GCTCTGTTCATAATCG-1	True	True	True
AACCTTAAGGCGAAAC-1	True	True	True
CAACTAATCTGCAAGT-1	True	True	True
GAGCTGCTCGCTTGCT-1	True	True	True
TTCAGCACAGTAAGTA-1	True	True	True
CCTAAGCCATTGTCAG-1	True	True	True
GTCCAGGGTACGGTAC-1	False	False	True
GCGCGATTCCCATAAA-1	True	True	True
ATGCCTGAGGCAACAA-1	True	True	True
ACGTTACAGTATTGGC-1	True	True	True
GTTAACCAGCCACAAT-1	True	True	True
CCTGTAACACTATGGC-1	True	True	True
TTTCTCACATTGCGAC-1	False	True	True
GTCGCAATCTCACAAA-1	True	True	True
ACGTACCCAGTAGCCT-1	True	True	True
TGTGCTGAGGATCCGC-1	True	True	True
ATATGGTGTATTTGGG-1	True	True	True
CGCATGATCCTGGTCT-1	True	True	True
AAACGCGCATGTTGCA-1	True	True	True
ACTTGAATCCCGTTAC-1	True	True	True
AAGCCTTAGGAGCATA-1	True	True	True
TTTGGTGCAGACAAAC-1	True	True	True
CAATCGCCAATTAGCT-1	True	True	True
GGAGTGAGTGTTAAAC-1	True	True	True
CCGACAGGTGGGTACT-1	True	True	True
AGCGCTCAGCTTATGA-1	True	True	True
ACCTCACTCATAAGCC-1	True	True	True
TATTCGTTCTTGGATA-1	True	True	True
GCTGACCAGGACACTT-1	True	True	True
TCCGCCATCAGCCAAT-1	True	True	True
CGGGCTTAGTCTGGGC-1	False	True	True
TCGCGAGGTGCATTTC-1	True	True	True
CCACACAAGACAAACG-1	True	True	True
GCTTTACGTACAATGT-1	True	True	True
CCCGCTTCAACGTGCT-1	True	True	True
TTGGCTGAGAAGGTGC-1	True	True	True
GAAGTGATCCCAGTAG-1	True	True	True
AGTTGCGTCTCCATGC-1	True	True	True
TTGGGTTAGTTAGAGG-1	True	True	True
CTAACCACAGTCTATG-1	True	True	True
AATAGAGGTCATAGAT-1	True	True	True
TATCGCACACAAACTT-1	True	True	True
CTCGACAAGGCCATCA-1	True	True	True
AACCGCTCAGCTCAAC-1	True	True	True
CAGCTCAAGCACAGAA-1	True	True	True
TTTCTCACACCTAATG-1	True	True	True
ACCATTAAGGAACGGT-1	True	True	True
CGGAGCAAGGCATTGT-1	True	True	True
ACTCACTGTCATTGTC-1	True	True	True
GTATGTTCAGGCCATT-1	True	True	True
CAATAAGCATTATCCC-1	False	True	True
GTTGGCCAGGCATTGT-1	True	True	True
TTTCATCAGATAACCC-1	True	True	True
CGCGGATTCATGGTGT-1	True	True	True
GACACTAGTGAGGTAG-1	False	False	False
GGTACTAGTGATCATG-1	True	True	True
GCATGAAAGACAACAG-1	True	True	True
GTACTGGTCTCTAGCC-1	True	True	True
GTGCATTAGGTGTTAC-1	True	True	True
TTGGGCGGTACCCACC-1	True	True	True
CTAGCTGAGTCACCTC-1	True	True	True
AAACCGGCAGCATGAG-1	False	True	True
GCGATTAGTTATCGAG-1	True	True	True
CGCATGATCCGCAAGC-1	True	True	True
ATTCCTCCAACTAACT-1	True	True	True
AGGGCTACAATTTAGC-1	True	True	True
TCCGCCATCCGTCCAT-1	True	True	True
GAACCAGCATGTCGCG-1	True	True	True
GATGCAGCACCAGCAT-1	True	True	True
AAGCGTTTCCGCATGA-1	True	True	True
ACGAAGTCATTATGCG-1	True	True	True
GTCGAAGCACCTATAG-1	True	True	True
AAGGATTAGGTGAGAC-1	True	True	False
CGTGACATCCTCAGCT-1	True	True	True
GACGCAACACCTAATG-1	True	True	True
TTAATCGAGACAAGTG-1	True	True	True
CCGCCAACAGTCTATG-1	True	True	True
CAAACACTCGCTAAAC-1	True	True	True
GCTATCCTCCTGAATA-1	True	True	True
CGGAGCAAGAATCGCT-1	True	True	True
GTAGGTGCAGTAATAG-1	True	True	True
ATATAGGCAATCCTAG-1	True	False	True
TTTGCGGAGTAACTCA-1	True	True	True
GGCTATTAGGAAGTAT-1	True	True	True
CTCATGCTCCGTTATT-1	True	True	True
TATCGAGGTTTCGCGC-1	False	True	True
AATTGACGTGGTTAGC-1	True	True	True
GCCTACTTCGGTAACT-1	True	True	True
GAGCTAGCAGTTTGTG-1	True	True	True
CAGCCTAAGGAGTCGG-1	False	True	True
AAGGTATAGCATGAAG-1	True	True	True
GGGCATGAGGCTGTGC-1	True	True	True
AGCTAGTTCCGCCAAA-1	True	True	True
TGTCCTGGTGTCACGG-1	True	True	True
GCTTTACGTACAAAGA-1	True	True	True
CGTGACATCTAAATCG-1	False	False	False
TGCTCCGTCGCTAAAC-1	False	True	True
GCAGGCAAGCGCCTTT-1	True	True	True
GGCATGGAGTTGTCTT-1	True	True	True
ACGATTCAGCATTTCT-1	True	True	True
CCCAATTGTCCGTAGG-1	True	True	True
GGATGTAAGTGAAGTG-1	True	True	True
AAGGTCAAGAAACTGG-1	True	True	True
CAGTACCCAATGAAGC-1	True	True	True
GATTCAGGTGCATTAG-1	True	True	True
GGATACTTCTTGCTAT-1	True	True	True
CTAGGCGGTCATAGAT-1	False	True	True
CTGACATAGCAAGGGT-1	True	True	True
TACTAAGTCTGGTCCT-1	True	True	True
TGAAACTGTTAAGTGT-1	False	False	True
TGAGGCACAATCCTAG-1	False	True	True
GTTGTTGCACGCAACT-1	False	True	True
GCCACTAAGGCGCTAC-1	True	True	True
TTAGGCGTCGTCAAGT-1	True	True	True
GTACTAGGTACCCACC-1	True	True	True
GCTTTATTCACCATTT-1	True	True	True
GTCGGTTCAAAGGTAC-1	False	True	True
TTGTTGTTCCGCAAAT-1	False	True	True
GTTACAGGTAGCTGGT-1	True	True	True
ATTGCGCCACTGGCTG-1	False	True	True
GACAATACAAATACCT-1	True	True	True
TTGGCGGGTAGGATTT-1	True	True	True
ACCTAAATCCTAGTCC-1	True	True	True
ACTTGCACAACCTGGT-1	True	True	True
GCTCACAAGGTAGCTT-1	True	True	True
GCTGTGATCTGTAATG-1	True	True	True
TTAAGGACAATGAGGT-1	True	True	True
TCGCCCATCTCACATT-1	False	True	False
CGTTATCGTTTGGCGG-1	True	True	True
TACCAAATCACAGCCA-1	True	True	True
CTTGACGAGAGGAAGG-1	True	True	True
CACTAAGGTAATTAGC-1	True	True	True
CTTCATCCAAACTGTT-1	True	False	True
AGCTACGTCCTGTTCA-1	True	True	True
CAAGGGAGTCCGTAGG-1	False	True	True
GGTAATTGTTCGGGAT-1	False	False	True
ATGACCAGTAACCTAG-1	True	True	True
GGTTAATGTAGCTGCG-1	True	True	True
ACAACAGAGGTTACGT-1	True	True	True
ACAGCGCTCGCTCACT-1	True	True	True
GTCTTTAGTGAGACTC-1	True	True	True
GATTGATGTCCCGGAA-1	True	True	True
GTGCGCAGTCACTCGC-1	True	True	True
CGTATTGCAAATGCCC-1	True	True	True
GACCTAGTCGCTCCAT-1	False	False	True
CAACTAATCATGTCAA-1	False	True	True
AATAGAGGTATTCGCT-1	True	True	True
GCATGAGCACGTAATT-1	True	True	True
TAGGCTGTCCCAGTAG-1	False	True	True
TGAGGTGCACAATGTT-1	True	True	True
GGAAGTATCTGCAAAC-1	False	True	True
GGCCGTTAGTAAGTCC-1	True	True	True
GGCGGTTTCCTCCTAA-1	True	True	True
GAAGCCTGTACAATGT-1	True	True	True
TGACTTCGTGCCGCAA-1	True	True	True
AAACCGGCAGTTTGTG-1	True	True	True
ATTCCTCCAGTCTATG-1	True	True	True
TTTCTCACATAGCGGA-1	True	True	True
CACATTAAGGGACTAA-1	True	True	True
GGCGGTAAGGCTATGT-1	True	True	True
GTCATTAAGCGCAATT-1	True	True	True
TTAAGTGTCGAGGTGG-1	True	False	True
CTAGATTCATTATGAC-1	True	True	True
TGTAACTCATCGCTTT-1	True	True	True
TTGTTTGGTTTATCTG-1	True	True	True
AGCCTAGTCAAACCGT-1	True	True	True
GTCTAACAGTTTGTCT-1	True	True	True
TCACCTGGTTCCGCAC-1	True	True	True
ATAACGACAGCACGTT-1	False	False	True
TTGCTTTAGTGAGCAA-1	True	True	True
CCTGACTTCCAAATCA-1	True	True	True
AGGACTAAGCACGTTG-1	True	True	True
TATTAGGTCTTACTCG-1	True	True	True
TAAACAGCACTAAGTT-1	True	True	True
ACACTTAAGTCTATGA-1	False	True	True
AATCAGGAGACTTACA-1	True	True	True
TTTAAGGTCATGGTGT-1	True	True	True
TTGCAACAGGAACGGT-1	True	True	True
GTTTAGCAGTAAGAAC-1	True	True	True
CGGGCTTAGTAGCCAT-1	True	True	True
GCAAGTGCATTAAGTC-1	True	True	True
TCTAGCACAAATTGCT-1	True	True	True
CCAGCTGCAAATACCT-1	True	True	True
CAGGTTTAGACTAAGG-1	True	True	True
TCAGCAAGTCGACTAA-1	False	True	True
GTACCGGGTCACAGCG-1	True	True	True
ATGCGATTCATGCTTT-1	True	True	True
CGCGGATTCTCTAGCC-1	True	True	True
AAGTGCAAGCTACTGG-1	False	True	True
ACTATGTCATGTTGTG-1	True	True	True
TACCCGGCAGCTTACA-1	True	True	True
GGTGTCCAGCAAACCT-1	True	True	True
CAGGCTATCCTAAGAC-1	True	True	True
CGTCAATAGTTAGGCT-1	True	True	True
CATTTGTTCTTGTCCA-1	True	True	True
TCGTTACGTTTGCGAA-1	True	True	True
GGGTTTCCACAAAGAC-1	True	True	True
GGAACCTGTAACCTAG-1	True	True	True
TTCTTAGGTGATCATG-1	True	True	True
ATCCTCATCACCGGTA-1	True	True	True
ATGCTTAAGGCAATAG-1	False	True	True
TGGTTCCTCAAGCTAC-1	True	True	True
CGCTTGCGTGCAATGC-1	True	True	True
GATCCGTCAGTTAAAG-1	True	True	True
TCAGCGATCCATTACT-1	True	True	True
GGTTCCCGTTATCCTA-1	False	False	True
TGCCGGTAGGTCAAAG-1	True	True	True
TTGTTCCCACGGTTTA-1	True	True	True
TCTAAGGGTGGACATC-1	True	True	True
TCGTGCTTCTACCTGC-1	True	True	True
GGAAACTCACAGGGAC-1	True	True	True
CCATAGCCAACCGCCA-1	True	True	True
AGGTCAAAGTTATGGC-1	True	True	True
CAGCCTTTCCTTAGTT-1	False	True	True
ACACTTAAGCTTAGCG-1	True	True	True
CACAAGCGTTTAGCTC-1	True	True	True
TAGGTGCGTTTGCAGA-1	True	True	True
TGATCAGGTTACTTGC-1	True	True	True
ATGTCATCATGAGTTT-1	True	True	True
ACGTACCCACAGAACG-1	True	True	True
CCGCTAAAGCGATACT-1	True	True	True
TCCTTAGTCATGCGTG-1	True	True	True
ACCTCACTCTCCATGC-1	True	True	True
TTGGCTACACGAATTT-1	True	True	True
GGGTGAAGTGTCACGG-1	True	True	True
ACCGGTTCATAGCAGG-1	True	True	True
GCTAACCCAATGAGGT-1	True	True	True
TACTGAGGTGTTAGCA-1	True	True	True
GACTATTCAGGTTTGC-1	True	True	True
CCTAAGCCACAATGCC-1	True	True	True
CATTATGAGGTTTACA-1	True	True	True
AGAGAGGAGTAACAGG-1	True	False	True
AAACGGATCATTAGTG-1	True	True	True
CAATATGTCACTCAAA-1	True	True	True
GTGTGCGGTACCTTAC-1	True	True	True
TATTCGTTCGGTCAGC-1	True	True	True
TACTAAGTCAGCTAAC-1	True	True	True
TCAGGTCCAAGCCAGA-1	True	True	True
AGGAAACGTTACCGGG-1	True	True	True
AATCCATCAGGCTAAG-1	True	True	True
GTGCTCCGTGGATTGC-1	True	True	True
TTTCGTCCATGGCCCA-1	True	True	True
GCGCAATGTGGGTGAA-1	True	True	True
CAAACACTCATTGCGG-1	True	True	True
TCTCGCCCAGTTTACG-1	True	True	True
TGCAGGCTCGTTTCTG-1	True	True	True
AGTCAGGCATTATCCC-1	False	False	True
ACGACTTAGCTGCACA-1	True	True	True
CATCGCTTCTAATCAG-1	True	True	True
CCGTTTGGTGGGTACT-1	True	True	True
TTGTTGTTCATCCACC-1	True	True	True
TAGGCTTAGCATGCAT-1	True	True	True
AGTGCGGAGACAACAG-1	True	True	True
GGGTTATTCGAAGCGG-1	False	True	True
GAACCTTAGCGAGTAA-1	True	True	True
GATTAAGCAATACTGT-1	True	True	True
CCCTCAGTCAGGAAGC-1	True	True	True
GCGATATTCAATTGGC-1	False	False	True
GGTTTCCTCCTAGTTT-1	True	True	True
GTGCGGTTCCGGTTGA-1	True	True	True
GCACTTACATTGACAT-1	True	True	True
AGCTTGGTCACGCATG-1	True	True	True
GCTGGATGTTGTAAAC-1	True	True	True
ACTTGTAAGCAAACCT-1	True	True	True
CCATCATGTTATCCGT-1	False	True	True
TGTAAGTGTTAGTGAT-1	True	True	True
CACAGGGAGCTTACTT-1	True	True	True
GCCCTCATCCCTTGCG-1	True	True	True
ATAAGCCTCGTTTCGC-1	True	True	True
ACTTACTTCTTTGAGA-1	True	True	True
ATACCGGTCAGTATTG-1	False	False	True
GCTATAGGTTAGCAGC-1	True	True	True
GTGTTCCTCGGGACTC-1	True	True	True
CGAGTCGGTACAAAGA-1	True	True	True
CGATGTCCACGAATTT-1	True	True	True
GTCGGTTCACGGTTTA-1	True	True	True
ATGGCTTAGTCTCACC-1	True	True	True
TAGCAGGCACCTAATG-1	True	True	True
TTCCACGGTAGGATTT-1	True	True	True
TTGGGCGGTAGCTGCG-1	True	True	True
GAGGCAAGTGATGAAA-1	True	True	True
GTTCCTTCACCTGCCT-1	True	True	True
GCCACACAGACAAACG-1	True	True	True
AAAGCCGCATAGCAGG-1	True	True	True
GTACTTAAGTAGCGGG-1	True	True	True
CTACTTAGTCGACTCC-1	True	True	True
AGTATAGCAAACGCGA-1	True	True	True
GTTTGTCGTTATGTGG-1	True	True	True
ACCAGGGAGCAAGGAC-1	True	True	True
GAAGGAACAAGGTCCT-1	True	True	True
CTAAAGCTCCTCGATC-1	True	True	True
GGTCGGTTCAGGAACA-1	True	True	True
CCCGCAACATCGCTTT-1	True	True	True
AGCTACTAGGGCCACT-1	True	True	True
ATGACGAAGGTTTGAC-1	False	True	True
CGCCAAATCTAGCGAT-1	True	True	True
TTAGTCAAGAATCGCT-1	True	True	True
CGAGGAAGTGTTGTGA-1	True	True	True
GCAATATGTACAATGT-1	True	False	True
ATCAAGACAGGCCATT-1	True	True	True
GATTCATCAATTGACT-1	True	True	True
TCGCATTGTCACAGAC-1	True	True	True
ACTTTGTTCGTTATAG-1	True	True	True
TGCGCAGGTTACAAAC-1	True	True	True
CCTTATGTCCATTACT-1	True	True	True
GTTAAGCTCAAGCCTG-1	True	True	True
AGTGCGGAGCTTCCCG-1	True	True	True
CCAGTTTGTACTTAGG-1	True	True	True
GTAGCCATCGCCTGTT-1	True	True	True
CTTAAGATCGCCTAAG-1	False	True	True
ATCACCCTCCGGTTGA-1	True	True	True
TTGTGAGGTAGCTGCG-1	True	True	True
ACCTGTTGTGAGAAAC-1	True	True	True
ATGCTTAAGTAACAGG-1	False	True	True
GTCATCACAGCATGGA-1	True	True	True
TGGACGGAGTTATGTG-1	True	True	True
AAATCCGGTTACATCC-1	True	True	True
CGGAGCAAGGTAAGCA-1	True	True	True
TTATCCGTCATCCACC-1	True	True	True
GTACTAATCCTGGTCT-1	True	True	True
TGAAACTGTTGCAATG-1	True	True	True
TGTGTGAGTTAGTACG-1	True	True	True
CGAAGTAAGTTATGGC-1	True	True	True
GGAAGTATCGGTTCCT-1	True	True	True
CCCTGTTAGCCGCTTT-1	True	True	True
GGTAACTTCTCACAAA-1	True	True	True
TCAGTAGGTGCCTCAC-1	True	True	True
GGTTATATCAATCTCT-1	True	False	False
ATTAGTCCAAGTAAGC-1	False	True	True
GATCGCTCATGAATCT-1	True	True	True
AGGTCATTCATCACTT-1	True	True	True
AGTACGCGTCCTAAGA-1	True	True	True
GAAAGCCAGTGAACCT-1	True	True	True
CGCTTCTAGGCAGGTG-1	True	True	True
GTGAGCGAGGCGTAAA-1	False	True	True
ACTTCGCTCCTTCGTA-1	True	True	True
CCTTCGGTCTTGATGA-1	True	True	True
CGTTGCAAGAGGAGTC-1	True	True	True
CAAACATGTTCCAGGG-1	True	True	True
AGTAACCTCAAACCGT-1	True	True	True
ATGCGATTCGCCTAAG-1	True	True	True
GGACAGCCAATTAGGA-1	True	True	True
TTGCTTTAGGGCTTTG-1	True	True	True
GTTCCTTCACTCGCTC-1	True	True	True
AATCTCAAGTATCGCG-1	True	True	True
ACAAAGGTCAAGTGAG-1	True	True	True
CTTCGCGTCACAGACT-1	True	True	True
GTGCTCAAGGTCCAAT-1	True	True	True
GGTCAGGAGTAACTCA-1	True	True	True
AATTTGGTCGCAGGCT-1	True	True	True
AAGCGTTTCCTAATGA-1	True	True	True
TTTGTTGGTTCCTGTG-1	True	True	True
GTAGGATCATCGCTTT-1	True	True	True
TCACATAAGTCGCAAT-1	True	True	True
GTTAACCAGGTCCTGA-1	True	True	True
TGATTAGTCCTGTTCA-1	True	True	True
CGCATTACAGCTTAAT-1	True	True	True
TTGGGCCAGTTAGGCT-1	True	True	True
TACCTTAGTGTGAGGA-1	True	True	True
GTTAAGCTCAAGCGCC-1	True	True	True
CCTATATTCTTAGGAC-1	False	True	True
TATCGAGGTACGATTG-1	True	False	True
AGGTTACTCGCATTAA-1	True	True	True
CGGCTAATCATGGTGT-1	True	True	True
AATGGCGCAATCCTGA-1	True	True	True
CGAGCGAAGTGAACCT-1	True	True	True
TCCGCCATCAAGTGTC-1	True	True	True
AAGCCTTAGTAGCGGG-1	True	True	True
CTAATCGCATTAGCCA-1	True	True	True
ATTAGCGGTGGACCTG-1	True	True	True
TTTCATCAGACACTTA-1	True	True	True
TCTAGCGAGCTCAAAC-1	True	True	True
GGCCTAATCCTCATCA-1	True	True	True
CTTCATCCAGAGAGCC-1	True	True	True
TGTTCCTCAATTAAGG-1	True	True	True
TTTCGTCCACAACCTA-1	True	False	True
AGTCAATGTACGGGTT-1	True	True	True
TCGTTAAAGTTAGACC-1	True	True	True
CTGGTCAAGCGCTAAT-1	True	True	True
GAAGTGATCGGTAACT-1	True	True	True
TTGTCCCAGTGAACGA-1	True	True	True
TATCCAGCAGGATTAA-1	True	True	True
TAGTAAGCAAGCGAGC-1	True	True	True
GCGAGTGAGTTAACCA-1	True	True	True
CCGCTTAGTGTAACCA-1	True	True	True
GTACCGGGTCACACCC-1	True	True	True
ACGGTTTAGTTTGGGT-1	True	True	True
AGAACCAAGGAACCGG-1	True	True	True
TAGGTTATCTGTAATG-1	True	True	True
CAAGACAAGTCATTGA-1	False	True	True
GTTAATGTCTGGCATG-1	True	True	True
GTCTAATCATAGTCAT-1	False	False	True
CAAAGTGAGGTGAAAT-1	False	True	True
GTCATGAGTGTAACCA-1	True	True	True
TGCTCAACAGCACGTT-1	True	True	True
GCTAATATCTGTGCAG-1	True	True	True
CTCACTCAGTTTCCGC-1	True	True	True
TGATCACAGCGCCTAA-1	True	True	True
CATAGGCGTTTAGCTC-1	True	True	True
GAAAGGCTCATAGACC-1	True	True	True
ATCCACCTCTTAGCCC-1	True	True	True
GTCAATATCGGTCAAT-1	False	True	True
TTGTTCCCATCGCTTT-1	True	True	True
CGTTAAATCAATGTCA-1	True	True	True
TGCTAGCCAATCGCAC-1	True	True	True
GCCCATAAGGTATTGC-1	True	True	True
ACGCACGGTGCTGTAA-1	True	True	True
GGCTCACAGGCATGAA-1	True	True	True
CGGACAACAAACTAAG-1	True	True	True
ATGCAAACATAGCGAG-1	True	True	True
AGGACTAAGCCATCAG-1	True	False	True
ATCCATAAGGCTGTCA-1	True	True	True
TTTACGAAGCTAATCA-1	True	True	True
ACCACATAGATGCCTG-1	True	True	True
TTAACTGAGGTCTTGG-1	True	True	True
TTGAGGCGTTAAGCTG-1	True	True	True
ATCGCTTGTTAAGGTT-1	True	False	True
CTCGCTCCACATAACT-1	True	True	True
GCGATTTAGAATGACG-1	True	True	True
TGTTCCTCAATGAAGC-1	True	True	True
CTCATCATCTTAATGG-1	True	True	True
TTTGTGAAGAGGAGGA-1	True	True	True
CTTACCGGTACTGATG-1	True	True	True
TTGTCCCAGCTTGCTC-1	True	True	True
ACGCACGGTTAGCGTA-1	True	True	True
ACATCAATCCAAGTTA-1	True	True	True
AAGGTCAAGTGATTCA-1	True	True	True
CTTACCTCAGTAGGTG-1	True	True	True
CCTACTTCAATATGGA-1	True	True	True
TTTATGGAGCCTTAAA-1	True	True	True
GCATCCTTCAGGGCCT-1	True	True	True
AATACCGGTGTTAAAC-1	True	True	True
CCTCAAACACTAAGAA-1	True	True	True
TCTAATCTCTCTAGCC-1	True	True	True
TCCCGTTAGTTTGGGT-1	True	True	True
TCGTTATTCGCTCACT-1	True	True	True
TTATGACCATCCTGAA-1	True	True	True
ACCTCACTCCTGTTCA-1	True	True	True
ACGCCACAGGCTGTCA-1	True	True	True
ACCCGTAAGCGATACT-1	False	True	True
GCTAGCCAGCTCATAA-1	True	True	True
AGTATAGCATAGCGGA-1	True	True	True
AAGTGTTGTGAGGTGA-1	True	True	True
ACACTAGGTTCAAGCA-1	True	True	True
TACAGGTTCCTTGCAC-1	True	True	True
AGGCCCAGTGAATCGC-1	True	True	True
GGCTTCAAGTCTTGAA-1	True	True	True
GGCAAGCCAACCGCCA-1	True	True	True
GATTGGCGTGATCATG-1	True	True	True
CAACCCGCAAGATTCT-1	True	True	True
GTTAGACTCCCGTTGT-1	True	True	True
TCGTTTCCACACTAAT-1	True	True	True
GATTCAATCCCTCAAC-1	True	True	True
CCGGTTAAGGTCCGTA-1	True	True	True
CGGCTAATCATGCTCC-1	False	True	True
GAACTTATCTTGAGCG-1	True	True	True
ACTTACTTCCGGTATG-1	False	True	True
GAGCCTTCACCTAAGC-1	True	True	True
GTTAAACGTCATTACC-1	True	True	True
CGGTGAACAGCAACCT-1	True	True	True
TATAGGTGTTCCGCAC-1	True	True	True
CGAGGCAAGCCTAATA-1	True	True	True
CATTGTAAGCCTGAGC-1	True	True	True
CTACGAAGTAGCCTCC-1	True	False	True
TTGCTCTCACCATATG-1	True	True	True
CATAATCCACAACCTA-1	True	True	True
CTAATTGAGTTATGGC-1	True	True	True
AGCGCTCAGGCTTAAC-1	True	True	True
AGTTGTCAGCCTCTCG-1	True	True	True
GATCGAGCATATTGAC-1	True	True	True
TTAAGGTGTGAAGCCT-1	True	True	True
AGTTTGCAGCCTGTGA-1	False	False	True
TTGGGCCAGCTTAACA-1	True	True	True
CCTCAATGTGCCGCAA-1	True	True	True
AAACCAACATAATCGT-1	True	True	True
CCTCAATGTTCACTGT-1	True	True	True
GAACCGCTCATTTAGG-1	True	True	True
GGCCTTAAGCTGAGGG-1	True	True	True
GTTGCATAGGAGTCGG-1	True	True	True
AGCTAGTTCAAGCTTA-1	False	True	True
GTTTATCTCATTCATC-1	True	True	True
CAGCCAATCCTAGTCC-1	True	True	True
CTGGTAAGTTATTGCC-1	True	True	True
TGACTTCGTTGAGCCG-1	True	True	True
AGCTCATAGTTGTCTT-1	True	True	True
ACTTAGGGTTCAAGAT-1	True	True	True
AGGTTACTCCAGGAAA-1	True	True	True
CTTAGGAGTTGTTCAC-1	True	True	True
GGACGGATCCTAGTCC-1	True	True	True
TGCGCAGGTGCTCACC-1	True	True	True
ACACCTTGTTACTAGG-1	True	True	True
AGTTTGCAGGGTCTAT-1	True	True	True
AACCTCCTCCTGGCTT-1	True	True	True
CAGCCTTTCTTAGTCT-1	True	True	True
TCTCAAGCAGTAGGTG-1	True	True	True
GCATGAGCAACCCTAA-1	True	True	True
TATGGCCCATGAGTTT-1	True	True	True
TCAAGAACAGCTCATA-1	True	True	True
CCTGGATCACGAATCC-1	True	True	True
TCCAGGTCACAAGCCT-1	False	True	True
AAACCAACACTAAGAA-1	True	True	True
TGTGGAGCAGTCTAGC-1	True	True	True
GCGAAGTAGGCCAATT-1	True	True	True
GAGGCTACAGGATTAA-1	False	True	True
TATAGGTGTGATGATT-1	True	True	True
ATTGGTTCAGGAACCA-1	False	True	True
CCGACAGGTGAGAAAC-1	False	True	True
GTAGGAGGTAACAGGG-1	True	True	True
ACCCTCCCAGCTACGT-1	False	True	True
ATGTTGTCAGCTCAAC-1	True	True	True
CGTGAGGAGCCAGTAT-1	True	True	True
ATCACCCTCCTGAATA-1	True	True	True
AATCCATCAGCCTTGG-1	False	True	True
GGATGAATCACAGACT-1	True	True	True
TTCCCACAGGGATGAC-1	True	True	True
TGATGACTCGATCAGT-1	True	True	True
CCTTACTCAAGCCACT-1	True	True	True
CGGCTAATCGGCTATG-1	True	True	True
TCGTTACGTTTGCAGA-1	True	True	True
TCCTCTAAGTCACGAT-1	True	False	True
TCAGTAATCTCTAGCC-1	True	True	True
CGATATTCAATAATCC-1	True	True	True
GTACCTTGTAGTTGGC-1	True	True	True
CGCACCACAAACGCGA-1	False	True	True
CCTCCTCTCCTTGTTG-1	True	True	True
TTTGCGGAGGCCAATT-1	False	True	True
GTGCTGGGTTTAGCGA-1	True	True	True
ATTGCGCCAAAGCCTC-1	True	True	True
CTAGATTCATTGTGTG-1	True	True	True
GCTAACAGTCAATACG-1	True	True	True
ATTGCTCGTGTTTGAG-1	True	True	True
ATTCCGGAGCTTGCTC-1	True	True	True
CGCATGATCATGCGTG-1	True	True	True
TTTGCGGAGGTAAGGC-1	True	True	True
GTTAATGTCTTAGGAC-1	True	True	True
TCAATCGCATGCAACC-1	True	True	True
GACTCACCAATTTAGC-1	True	True	True
AACAGATAGCGGATTT-1	True	True	True
TGTTGTAAGTAACGAG-1	True	True	True
ATATGTCCAAGGTATA-1	True	True	True
AAAGGCTCAGCATGTC-1	True	True	True
TTGTGAGGTTGGATCA-1	True	True	True
CCTATAGCACCTGCTC-1	True	True	True
CCTGTTGGTACTGAAT-1	True	False	True
TGCTTCCAGGCTCATG-1	True	True	True
CATGGCGGTGCTAGCG-1	True	True	True
GCTTGTTGTAGCTAGC-1	True	True	True
TACTGCACATAGCGAG-1	True	True	True
GTTTACCGTTGTTGTC-1	True	True	True
AGTCCTGAGGGCTAAA-1	True	True	True
GTCTTGCTCGAAGCGG-1	False	True	True
AAGACATAGCGAAGTA-1	True	True	True
ACTTGTCGTTACAACG-1	False	True	True
ATCAATCCACCTAATG-1	True	True	True
GAGGCTACAGGTTTGC-1	True	True	True
AGAGGATGTTTGAGGC-1	True	True	True
CGACAAGCACCTACGG-1	False	True	True
AACGCTAGTAACCAGC-1	False	False	False
ATCAAGACAAATGCCC-1	True	True	True
ATGCGATTCTGTAAGC-1	True	True	True
TAGTGGCGTGCTAGAC-1	True	True	True
GTGCCTTTCCCGAACA-1	True	True	True
TGGATTCAGCTGCACA-1	True	True	True
CACTTTGTCCTAGTCC-1	True	True	True
ACCTAAGGTTGTAAAC-1	True	True	True
GGACATAAGATGGACA-1	True	True	True
ATCACAATCTTAGCCC-1	True	True	True
AGGTCATTCATCCACC-1	True	True	True
TGATTAGTCATGGCTG-1	True	True	True
TTCGGTACATGCAACC-1	True	True	True
CAGGAAGGTGACATGC-1	True	True	True
CAATCCTGTTCGGGAT-1	True	True	True
GGCCAACTCCTCGATC-1	True	True	True
TTGTTGCGTTAGCATG-1	True	True	True
GGGCATTGTACCCACC-1	False	True	True
TCAAACCAGGTGAGAC-1	False	True	True
GTTCGCTTCCTGAGTG-1	True	True	True
CAAGGTTTCTAGCGTG-1	True	True	True
GTCATTAAGTAAGAAC-1	True	True	True
AGGCGGATCCGTCCAT-1	True	True	True
TACTAAGTCCTCCTAA-1	True	True	True
GACTTACAGGCGGGTA-1	True	True	True
GCCATTACAGCTACGT-1	True	True	True
CTAATCCGTAGCAGCT-1	False	True	True
GAGCGAAGTTTAGTCC-1	True	True	True
TTACCGTGTTCATCTA-1	True	True	True
GCAATATGTACGATTG-1	True	True	True
CATTCCTCACAGAACG-1	True	True	True
CGAGGCAAGCCGCTTT-1	True	True	True
CGTAGCGGTTACCGGG-1	True	True	True
CTGTTCATCCGGCTAA-1	True	True	True
TTAGCCTGTGAGGTAG-1	False	False	True
ACGTTGTAGTGCTGTG-1	True	True	True
TATGACATCTGGCATG-1	True	True	True
GCCAATTAGATGCCTG-1	True	True	True
ATACCTGCAGAAATGC-1	True	True	True
ATTGCGCCATTGTGGC-1	True	True	True
CGTGTTACACTTAACG-1	False	True	True
GGGTTTCCACTAGCGT-1	True	True	True
TGATTAGTCGCTATGG-1	True	True	True
ATTAGTCCACGTGCTG-1	True	True	True
GCGGGTTTCCATAATG-1	True	True	True
TAGTGAGAGGAGGGTT-1	True	True	True
CCAACCAAGTAGGATG-1	True	True	True
CCAAGGCTCCTTCTAG-1	True	True	True
CGGACCTAGCAGGTGG-1	True	True	True
TGCCATTGTTGACTTC-1	False	True	True
GTACGTAGTCCTAATC-1	True	True	True
GGTTTCCTCTCCATGC-1	True	True	True
AGAGATTAGGCCGGAA-1	True	True	True
GTTGGCCAGACTATTG-1	True	True	True
CGCCAAATCCCTTGCG-1	True	True	True
CAAGAACCAAGCTAAA-1	True	True	True
AGAGGATGTTGCTTCG-1	False	True	True
CAATGACTCTCAATGA-1	True	True	True
TTAACCAAGGTTTACA-1	True	True	True
GCTTTATTCGCTTCTA-1	True	True	True
GCATTGCCATAATCGT-1	True	True	True
GCAGGATAGCTCAATA-1	True	True	True
CGAGCTGGTGTCACGG-1	True	True	True
AATCATCCATAAGTTC-1	False	True	True
AGCATCCCATGCTATG-1	True	True	True
AATTAGCGTACTTCAC-1	True	True	True
ACTTGAATCGTTACTT-1	True	True	True
CTGTGTGAGGTACCGC-1	True	True	True
TGGCTATAGACTTACA-1	True	True	True
GTATTCAAGGTGTTAC-1	True	True	True
CTATAACCAGCATTAT-1	True	True	True
AATCATGTCAATCTAG-1	True	True	True
CGAATCTAGCGCCTTT-1	True	True	True
TTCGGTACACCCACCT-1	True	True	True
ACCTGGATCTGTAAGC-1	True	True	True
CACTAGCCAGGCGATA-1	True	True	True
TAAGGCTTCTGGTCCT-1	True	True	True
GCTTCGCGTCCAAGAC-1	True	True	True
TCACCTGGTATTTGCC-1	True	True	True
CACTAAGGTAGTTAAC-1	True	True	True
CGCTCCATCAGGATGA-1	True	True	True
CTGCTATGTATACTGG-1	True	True	True
TGCTCACTCTTACTCG-1	True	True	True
TCTGGCTTCACCAATA-1	True	True	True
CCAACCAAGCGCAATT-1	True	True	True
TACCGCAAGCCTGAGC-1	True	True	True
AATCATGTCCCTCAAC-1	True	True	True
ACCCGTAAGGCAAGTA-1	True	True	True
TCTAAGGGTTAACACG-1	True	True	True
TTTAGCAAGCTATTGA-1	True	True	True
TACTCAAAGCACTAGT-1	True	True	True
GCTGTGCAGTGAACCT-1	True	True	True
GCCAACATCCCTCACG-1	True	True	True
CGCTTCTAGCCGCTAA-1	True	True	True
AAAGGAGCATGCTCCC-1	False	True	True
GGGCATTGTCCGTGAG-1	False	True	True
GTTACGCCACCCACCT-1	True	True	True
AGGATATAGTCAGTAC-1	True	True	True
GAGGCTACAATAACCT-1	True	True	True
GTCGAGGAGGCAATAG-1	False	True	True
GGACGGATCGATATTG-1	True	True	True
ATGTTGTCACTTCATC-1	True	True	True
TGTGGCCAGCGGATTT-1	True	True	True
ATTCATGAGAGAAGGG-1	True	True	True
TACAAGCTCCCGAAGC-1	True	True	True
CAAACCGTCATGGCTG-1	True	True	True
CTTTGTCCACATAACT-1	True	True	True
GTTACGTAGGCTAGAA-1	True	True	True
CAGCATGTCTTAGTGA-1	True	True	True
CGGTTATAGGCAATAG-1	True	True	True
TAATGGTGTGTTTGTC-1	True	True	True
CGAATATGTCTTGCAT-1	True	True	True
GAGCTGCTCCAACTGG-1	False	False	True
ATCAGGTTCTGTAATG-1	True	True	True
TGCTTGTGTGTTTGCT-1	True	True	True
CAATGAACAATTGAAG-1	True	True	True
TACAATGTCGAGGAAC-1	True	True	True
GTAATAGCAACTAGAA-1	True	True	True
TAACCGGTCGTTAGTA-1	True	True	True
ACTTGTCGTTTAACCC-1	True	True	True
TCCGGAATCGAGCTAT-1	True	True	True
ACTTCGCTCGTTACTT-1	True	True	True
CCTATTTAGGTCGAGG-1	True	True	True
GTCTAACAGAGGAGTC-1	True	True	True
CGGGACAAGGCCTTAG-1	True	True	True
CTCTTGATCGATATTG-1	True	True	True
CCAAGTTAGTAGGCGG-1	True	True	True
CATCAGCCACCGGTAT-1	False	True	True
CCTCAGTTCGATTATG-1	True	False	True
GATTACTCAGTTGCGT-1	True	True	True
CAAGGTTTCATGGCCA-1	True	True	True
TGGTCAGTCGACAAAG-1	True	True	True
ACGATTCAGTCTGGGC-1	True	True	True
AGGAAACGTCAGGAAG-1	False	True	True
CGAAGGCCAGGAACCA-1	False	True	True
GGAGCATAGGATCACT-1	True	True	True
ACTAGGCGTAATTAGC-1	True	True	True
ACGTACCCAGGTTTGC-1	False	True	True
CCGATGCAGGTTTGAC-1	True	True	True
TAAGTGCTCACCTGCT-1	True	True	True
CAGTATGGTTGGCGTG-1	True	True	True
GCTATCCTCCTCGATC-1	True	True	True
TAATGCATCCGCAAGC-1	True	True	True
ACTTATGAGGCTAGAA-1	True	True	True
CATTATGAGTGAACGA-1	True	True	True
GTTCGCTTCAGGCCTA-1	True	True	True
TAACCAGGTTCCATTA-1	True	True	True
TTCCACGGTGGATTCA-1	False	True	True
AAAGCTTGTGAGCAAG-1	True	True	True
ATTAGGTGTTGTCCAT-1	True	True	True
TCTTAGTTCCAGGGAG-1	True	True	True
GCTTACCTCAATTGGC-1	False	False	True
AAACATGCAGTTTCTC-1	True	True	True
CCTTCGTAGTTTAACG-1	True	True	True
GGTGAGTAGGGATTAG-1	True	True	True
ACCAAGTTCCCGAAGC-1	True	True	True
GGTATGTTCTCCATAT-1	True	True	True
GATGCTTAGAGAGGCT-1	True	True	True
CTCAATAAGCTTACTT-1	True	False	True
GATTCATCAAGGGTTG-1	True	True	True
GCGCTAGGTTTGTTGC-1	True	True	True
GGTGAGCCAAGCCAGA-1	False	True	True
TTTAGCAAGCGTGCAC-1	True	True	True
AGGTTTGGTCCGTGAG-1	True	True	True
CGTGCTTTCATGCTTT-1	False	True	True
CTCATCATCACTAATG-1	True	True	True
TAAGCCAGTGTTTCAC-1	True	True	True
CGGGCTTAGGAACGCG-1	True	True	True
ATCGCCCGTCATAACG-1	True	True	True
CTAGATTCAGATTCAT-1	True	True	True
CAGTATGGTTTGAGCA-1	True	True	True
CAGCAAGCAGGTTATT-1	True	True	True
TACCTGCTCAACAAGG-1	True	True	True
ATTGCACAGTTTGGTA-1	True	True	True
CAAACACTCACGCATG-1	True	True	True
GAGTGTTTCTGCAAAC-1	True	True	True
AGACAATAGTCCTTTG-1	True	True	True
CTCCGGACACTTCATC-1	True	True	True
GGGCATGAGTCCTTCA-1	False	True	True
TGTGCGGGTTCACCAT-1	True	True	True
CGGTTTGAGTCAATCA-1	True	True	True
ACTTGAATCGCAACAT-1	True	True	True
GTTTGCTGTCCGTGAG-1	True	True	True
CGGCAATGTCAAACTG-1	False	True	True
TCTTTGTAGTTTGTCT-1	True	True	True
CCGGTTAAGCCTGAGC-1	True	True	True
TAGCCGGGTATTCGCT-1	True	True	True
TAGCGCGGTAACTACG-1	True	True	True
GTTGCATAGGGATGCG-1	True	True	True
CGCATTACACATAACT-1	True	True	True
AACAGATAGCGCTCAA-1	True	True	True
AGCCGCTAGGCGCACT-1	True	True	True
AATGCGCGTTGTTCAC-1	True	True	True
TCTCACCAGCCAGTAT-1	True	True	True
GGCTAGACAGCCTGCA-1	False	True	True
CGTCAATAGTCGCTAG-1	True	True	True
AGTGCGGAGCCACAAT-1	True	True	True
TCGTTATTCCGCCTCA-1	True	True	True
TTGGTGAGTCGCGCAA-1	True	True	True
TATTGACCAGGCATCT-1	True	True	True
TCCGGTTTCCACCTGT-1	True	True	True
CTTGCATGTTAAGGCC-1	True	True	True
GATAACGAGCACCACA-1	True	True	True
CGAGCTGGTAATGACT-1	True	True	True
ACTCACCTCCAATAGC-1	True	True	True
GCTGCACAGAAACTGG-1	True	True	True
CCTTAGTGTACGATTG-1	False	False	True
GCATCCTTCCGGTTAG-1	True	True	True
TTTAGCAAGGAAGCTA-1	True	True	True
GTTCATTTCTTAGGAC-1	True	True	True
CAGCATGTCATGCCTC-1	True	True	True
GTAAGCTTCAGGGCCT-1	True	True	True
AAACATGCACAACAAA-1	False	True	True
ATCCCGCGTTGCTGGG-1	True	True	True
GGTACAAAGCACCACA-1	True	True	True
CAGGGCTTCGTTAGCG-1	True	True	True
GCCTTTGGTAACGTGC-1	True	True	True
GTGCTGATCAATCTAG-1	True	True	True
TACTGACAGGACCAGG-1	False	False	True
TGCGGTTCAATACTGT-1	False	True	True
ACTTAGTCAGGCTAGA-1	True	True	True
TTACACCGTCTAACCT-1	True	True	True
GTCTAATCAGCAAGTG-1	True	True	True
TAGTAAGCACGAATCC-1	True	True	True
TGCATTAAGTTATGGC-1	False	False	True
ATGTTCAAGCTAAGTC-1	True	True	True
GATGCTTAGGTTTGAC-1	True	True	True
CGTTGCGCATAGACTT-1	True	True	True
GGCATTGTCATTTGCT-1	True	True	True
TTGGCTACAAGCCAGA-1	True	True	True
CAAAGGATCGGGACTC-1	True	True	True
GTGATCAGTCCGGTTC-1	True	True	True
TCAGGTCCACAATTAC-1	True	True	True
CGGTGAACAGGTCCTG-1	True	True	True
CTATGGCCACCAGCAT-1	True	True	True
TGGCTATAGGCGTAAA-1	True	True	True
CCCTGTTAGGATTTGC-1	False	True	True
TTGTTGTTCCGGTTAG-1	True	True	True
CCGTTAACAAACCTTG-1	True	True	True
ACCTGGATCCGCCTCA-1	True	True	True
GAGCTGCTCCGCAACA-1	True	True	True
ATTATGGTCAAGGACA-1	True	True	True
GGCCTTCGTGTGCACG-1	True	True	True
GACCTAGTCATCCTCA-1	True	True	True
TAGCATATCAAATCGC-1	True	True	True
CGCATGATCGGGACCT-1	True	True	True
AGTCTTGCAAATATCC-1	False	True	True
ACCACACCAATGCCTA-1	True	True	True
ATGACAACAGCTAATT-1	True	True	True
TCATGAGGTGAAGCCT-1	True	True	True
GTTTCAGCAGCAACCT-1	True	True	True
GTCATGAGTCACCTAT-1	True	True	True
TAGGAGGGTGTGCACG-1	True	True	True
GTGCACGGTGCGCAAT-1	True	True	True
GATGGCTGTCATGAGC-1	True	True	True
CGTCAATAGCACAGAA-1	True	True	True
GGCTTCAAGTTCCCGT-1	True	True	True
GGTTGCTCACCCACCT-1	False	True	True
TAGCGGACACTTAGGC-1	True	True	True
CGAAGAATCCTGAATA-1	True	True	True
GCTATCCTCACCTGCT-1	True	True	True
GTGGTTAGTCAGGCCA-1	True	True	True
TGGACGGAGACTCGCA-1	True	True	True
CACATGCCAGTTTACG-1	False	False	True
TCCCGTTAGAAAGGAA-1	True	True	True
CGAGCGAAGTGAGGTA-1	True	True	True
TGGCTATAGGACACTT-1	True	True	True
TGATCAGGTAGCTGGT-1	True	True	True
GGCCTAATCTTGTCTG-1	False	True	True
TTGATGTCACCTAATG-1	True	True	True
ACCTGTTGTGTGCACG-1	True	True	True
TGTGGAGCATGAATAG-1	True	True	True
CCAAGTTAGCAGGTGG-1	True	True	True
AGCGTGCTCAGTGAAG-1	True	True	True
TATGAAGCATTAAGTC-1	True	True	True
TACTTGTTCACGCATG-1	True	True	True
GCCTAATAGGCGCTTA-1	True	True	True
TAGCGCGGTTCATTTG-1	True	True	True
CAGGTCCAGGAGTCGG-1	True	True	True
CCTAAGGTCGCAATCG-1	True	True	True
AGTTTGCAGGTCCAAT-1	True	True	True
CACAGGCTCTCCTCAA-1	True	True	True
GCTCTGTTCTAAATCG-1	True	True	True
TTCAGGTAGCGGATAA-1	True	True	True
CACCTGTTCTGCAACG-1	True	True	True
TGCGATTAGCTATGAC-1	False	True	True
AGGATGCAGCCTGTGA-1	True	True	True
TCGTGCTTCTACCTAT-1	True	True	True
TGCTTAAAGTAAGTCC-1	True	True	True
TTGCGTCTCAAGCTTA-1	False	False	True
GGTAATTGTTAGAGGG-1	True	True	True
GGTTGCATCTCACTCA-1	True	True	True
GACCTAGTCGTCATTT-1	True	True	True
CTCCTCACACAGGAAT-1	True	True	True
CTTTAGGCAGAGGCTA-1	True	True	True
CTAACCCTCCCTGATC-1	True	True	True
ATCACACAGAGGCTAA-1	True	True	True
AATCCCTGTGTTGCAA-1	False	True	True
GGCCTAATCTGTTCAT-1	True	True	True
CCACAATAGTATTGCA-1	True	True	True
CTTCTCAAGCGAGCGA-1	True	True	True
CAGCATGTCTACCTGC-1	True	True	True
TGAGGTGCATCCCGCT-1	True	True	True
AGGAACCAGGATTTGC-1	True	True	True
AGTTGCGTCCCTTGCG-1	True	True	True
CGAGGCAAGACACTTA-1	True	True	True
CTATTACTCATGAAGG-1	True	True	True
ATGTAAGCATAATGAG-1	True	True	True
GTCTATCGTCACACCC-1	False	False	True
CTAAATGTCATAACCA-1	True	True	True
TAGGGTTTCATTTAGG-1	True	True	True
AATAGAGGTATTGAGT-1	True	True	True
TGTTCCTCAAACTAAG-1	True	True	True
GGTATGTTCCCGAACA-1	False	False	True
GTGGTTAGTGCACGCA-1	True	True	True
GATCCGTCATTGCGAC-1	True	True	True
ACCCGTAAGCATGCAT-1	True	True	True
GTAGGTGCAGCGCTTG-1	True	True	True
GGCAATCGTTAGTGAT-1	True	True	True
TTGGGCGGTTGGTTCT-1	True	True	True
ACTTACAAGTTCCCGT-1	True	True	True
GCAAACCGTACGGTAC-1	True	True	True
GTTTCCTCAAGCTAAA-1	True	True	True
GACAATACACCCACAG-1	False	True	True
CAGAACCGTTGTCATC-1	True	True	True
TGCTTAAAGGTATTGC-1	False	True	True
TGTGCACCATAGACTT-1	True	True	True
GAGTAATAGGTCAAAG-1	True	True	True
TTAGGATGTAAGGTCC-1	True	True	True
CTTACCGGTTTCGCCA-1	False	False	True
ACCCGCTGTCCTAACT-1	True	True	True
GTAGGTGCATTTGCTC-1	True	True	True
CAATGTGGTGCTAGCG-1	True	True	True
GCATTAGGTCACAGAC-1	True	True	True
CAATGTCAGCCAGGTC-1	True	False	False
TCAATCGCATAGACTT-1	True	True	True
CAGCCAATCATTTGCT-1	True	True	True
GTAGTTATCGTCCTTA-1	True	True	True
CAAGGGAGTGCTCCGT-1	True	True	True
AGCTACGTCCTAGTTT-1	True	True	True
AAGGATGTCGCTATGG-1	True	True	True
TAGGCTTAGTAACGGA-1	True	True	True
ATGTCATCAGCATGTC-1	True	True	True
TGGTCATAGTCATTGA-1	False	True	True
GCTTAGTAGGCCATCA-1	True	True	True
ATATGCATCTGTTCAT-1	True	True	True
CTAGCGGGTGAGACTC-1	True	True	True
TACCGAAGTCAAAGAA-1	False	True	True
CTGCTATGTTTGGGTA-1	True	True	True
CGCATATAGTCACCTC-1	True	True	True
AACAAGCCACTCAACA-1	True	True	True
ACCAAGTTCTCAATTC-1	True	True	True
TTCCTCAAGATGGAGC-1	True	True	True
AGCGCCTAGGGACGCA-1	True	True	True
ACTCGCGCAACACCTA-1	True	True	True
TTAGCAATCTGCAAGT-1	False	True	True
CCGCACACAATCCCTT-1	True	True	True
CTGGTCAAGCTTGCTC-1	True	True	True
TTAAGCCAGCCTCTCG-1	True	True	True
AGCTAAACACGAATCC-1	True	True	True
AGGAGCTAGGCGTAAA-1	True	True	True
GTGGACACATTGTCCT-1	True	True	True
TTTGGCTGTATTGTGG-1	True	True	True
AGGTTGCGTGGACCTG-1	True	True	True
TCACCTCAGCTGTCAG-1	False	True	True
GTTGCATAGCGCTCAA-1	True	True	True
TACTTCGTCAGTTCCC-1	True	True	True
CGAAGCGAGAAGCTAG-1	True	True	True
TTACCTGTCTAATCAG-1	True	True	True
AGGATATAGGTCCTAG-1	True	True	True
TCACCTCAGTTATTCC-1	True	True	True
TGTGGCCAGGCGAAAC-1	True	True	True
TTGCCCGTCAGCCAAT-1	True	True	True
CAATGAACACCTATAG-1	True	True	True
GGGCCTAGTCACCAAA-1	True	True	True
ATCCTCATCATCACTT-1	True	True	True
TATTCGTTCATTTGCT-1	False	True	True
TCTAGCACACGTAAGG-1	True	True	True
AATTTGGTCCCGTTAC-1	True	True	True
AATCTTGAGGACCTTG-1	True	True	True
TGACTTCGTTGGCCGA-1	True	True	True
TGTAATGTCAGGCTAT-1	True	True	True
ATGGCCCAGTAAAGGT-1	True	True	True
CCGTTGCGTGATGAGG-1	True	True	True
GCCTACTTCTTAATGG-1	True	True	True
TGCACTTGTGCTGGTG-1	True	True	True
AATTTGCCAGAACCGA-1	True	True	True
CTCGCTAGTAATAGCT-1	True	True	True
GATTCCTGTTTGCGAA-1	True	True	True
TGCACACCACTCAACA-1	True	True	True
TTCCTCAAGTATTGGC-1	True	True	True
GGTAAACCACCGTTCC-1	False	True	True
ATGACAACACCTGGTG-1	True	True	True
CAAGCTAGTTAACGAT-1	True	True	True
TGAAGGATCGCATTAA-1	True	True	True
CTAGTGAGTTAGCATG-1	True	True	True
CACATACAGTTGGGCC-1	False	True	True
AGGTTAGAGCTTCCCG-1	True	True	True
TCAAGTATCTAGCTTT-1	True	True	True
ATGTAACGTCCCGAAG-1	True	True	True
TAGTAACGTGGATGTC-1	True	True	True
TTTCAGTTCAGCAAGA-1	True	True	True
AACAGCAAGCACTAAC-1	True	True	True
AGCAATTGTAATCCCT-1	False	False	True
ATGAATGCATCCTAGA-1	True	True	True
ACGAACAAGTCCTTCA-1	True	True	True
GGTTACCCAGTAGGTG-1	True	True	True
CAATGACTCCACCTGT-1	True	True	True
GGGCATGAGTTAGCTA-1	True	True	True
GAACACAAGCTCATAA-1	True	True	True
GTACTAATCGTTAAGC-1	True	True	True
CTGGTTTGTACGTTTC-1	True	True	True
TGAGCCGGTTCACCCA-1	True	True	True
GGGATTAAGTAGCTTA-1	True	False	True
GTAGCGCTCCTTGAGG-1	True	True	True
GCGATATTCGTTCACC-1	True	True	True
CATAGGTTCTTGCATT-1	False	True	True
GGCTATTAGGCTGTGC-1	True	True	True
TAATGCATCGAGCAAA-1	True	True	True
GTTACAGGTAAGGTTT-1	True	True	True
GATAGACCATTGGGAG-1	False	True	True
CGGAGCAAGCCAAATC-1	True	True	True
GTAAGCTTCAGCCAAT-1	True	True	True
CCGCTAGCAAGTTATC-1	True	True	True
CAGCATGTCTCACACC-1	True	True	True
CGTAGCGGTAAAGCAA-1	False	False	True
GACACCGGTTTAGTCC-1	True	True	True
TAGGAGGGTACGATTG-1	False	False	True
AGGATGCAGGTCTTGG-1	True	True	True
GGACCGAAGCGGGCAA-1	True	True	True
TACATCAAGTGAACCT-1	True	True	True
GCCTTACTCAGGAACA-1	True	True	True
ACACCTTGTGTGTCCC-1	True	True	True
CAATAAGCAGGTATTT-1	True	True	True
ATCCGTGAGGAGGACT-1	True	True	True
TCGCATTGTGGATTAT-1	True	True	True
ACGGGAAGTGATCAGC-1	True	True	True
TGAGGGAGTGTCCAGG-1	True	True	True
TTTGAGTCATAATCAC-1	True	True	True
GAGTGATCATTGCGAC-1	True	True	True
TCGGTTTGTAGGTGTC-1	True	True	True
TTCGTTAGTAGTTGGC-1	True	True	True
ACCACATAGGTAACGA-1	True	True	True
CATATCGCACAGAACG-1	True	True	True
TAATTGCCAAATGCCC-1	True	True	True
CAATAAGCAATACTGT-1	True	True	True
ATCGAGGCAAGGTCGA-1	True	True	True
ATAAGCCTCATTTGCT-1	True	True	True
GACCTGCAGGACACTT-1	True	True	True
ATGGCTAGTAGTTACG-1	True	True	True
AGGTGAATCACAGCCA-1	True	True	True
TTATGCGCACAGACTC-1	False	False	True
TGGACGGAGACTATTG-1	True	True	True
CAATGTGGTCGTAATG-1	True	True	True
CTGATCACAGTTTCTC-1	True	True	True
CCTTACTCAATAATGG-1	True	True	True
GGCTGAGAGACAACAG-1	True	True	True
CTACAACAGACACCGC-1	False	True	True
CACGCAATCAAGCCTG-1	True	True	True
GCCTATTGTTTGGTTC-1	False	True	True
ATCATCAAGCATTTCT-1	True	True	True
GTATTGATCGATTCTT-1	True	True	True
TGTAACTCACCAGGTT-1	True	True	True
CTCATGACAGGTTACC-1	True	True	True
TGCCGGTAGGCGTAAA-1	True	True	True
TAAGCTATCATAACGC-1	True	True	True
ATCACAATCCATAATG-1	True	True	True
GAATTTGTCCCTGATC-1	True	True	True
CTACTAAAGTAAGAAC-1	True	True	True
TTGGGCCAGACAAGTG-1	False	True	True
ATAAGCCTCTTGCTAT-1	True	True	True
CACCAACCAAGGTATA-1	True	True	True
AAACATGCAAATGCCC-1	True	True	True
CACCTCAGTAACTACG-1	True	True	True
TTGGCTGAGCATGACT-1	False	False	False
ATGGTTATCGCAAACT-1	True	True	True
GGCTGAGAGGGTGAGT-1	False	True	True
TGTAATGTCTTGCATT-1	True	True	True
AGGCGGATCGTAATCA-1	True	True	True
TGGTTCCTCCCTGATC-1	True	True	True
GATTCAGGTAATCCCT-1	True	True	True
CCAAGTTAGTGGCGGA-1	True	True	True
GATTGGTTCTCCTCAA-1	True	True	True
TGTTACTTCTTGGACG-1	True	True	True
AGGCCCAGTGCGCATG-1	False	False	True
GATGGCTGTGATCAGC-1	True	True	True
GCCAATTAGTTAGTTG-1	True	True	True
CAGGGTGAGGGATGCG-1	True	True	True
GTATTGCAGCCTGGTA-1	True	True	True
CAATAGCTCCGCACAA-1	True	True	True
GCTGGTTCATTGTGGC-1	False	False	True
CGGGTCTAGCGGATAA-1	True	True	True
GTTTACCGTTGCACGG-1	True	False	True
AGCAACAAGTGGCGGA-1	True	True	True
CAGAATCTCTAACCTT-1	True	True	True
TCTAGCACAATGAATG-1	False	True	True
TTTGTCTAGGCAACAA-1	False	True	True
GGGTGAAGTGCTGGTG-1	True	True	True
TTTGCGACAAACTGTT-1	True	True	True
CCGCAAATCTCAATGA-1	True	True	True
ATGTTCAAGTGAGAGC-1	True	True	True
GATTACGGTTAGCAGC-1	True	True	True
GGTCCGTAGTCAGTAC-1	True	True	True
TATTTGGAGTTTGAGC-1	False	True	True
CGCCAAATCGGGCCAT-1	True	True	True
ACCAGGCTCCTAAGGT-1	True	True	True
CCGACAGGTAACGAGG-1	True	False	True
CGAAGTAAGTTCCCGT-1	True	True	True
TCATGCCTCCTTGAGG-1	True	True	True
ATGACTCAGGATGATG-1	True	True	True
GCTTATCGTTTATGGG-1	True	True	True
CTATGGCCAGCACCAT-1	True	True	True
TGAACAACATTCCTGT-1	False	True	True
GTTCCCAGTTGGTTGA-1	True	True	True
GGTCAATTCAACCAAC-1	True	True	True
CCAACCAAGCGATAGA-1	True	True	True
TTCGTGCTCTACTAAG-1	False	True	True
GGCCTTCGTTAGCAGC-1	True	True	True
CTACCTCAGCTGTCAG-1	True	True	True
CGCATTACAAGCCACT-1	True	True	True
TTGGCTGAGCGCCTTT-1	False	True	True
TAATGGACAACAACAA-1	True	True	True
ATTTAGGTCAGCTAAC-1	True	True	True
GTACTAATCAGGATGA-1	True	True	True
CTTGAATCATTTGCTC-1	True	True	True
CTCGACAAGAGAGCCG-1	True	True	True
CGAAATGAGCCGCTTT-1	False	True	True
TGCTTCATCATCCTAT-1	True	True	True
CAGGCTATCCTGATGG-1	True	True	True
TATGGTCAGGGCTAAA-1	False	True	True
CTTCAAGCATGAGTTT-1	True	True	True
GCGGAACCACTAAGCC-1	True	True	True
CTCATTAGTCCCGGAA-1	True	True	True
ATTGTCCGTAATCGGC-1	True	True	True
GTTGCCCGTTAGCGTA-1	True	True	True
GATGCATTCATTACTC-1	True	True	True
TTCAGGTAGTCACCTC-1	True	False	True
GAGTGATCATGTTGGC-1	True	True	True
AATTTGCCATGAGTTT-1	True	True	True
GTTCATTTCCTGGTGA-1	True	True	True
CCGCTAGCATAGACTT-1	True	True	True
ACCGGTTCATTAGGCC-1	True	True	True
CCAAGTTAGTTATGGC-1	True	False	True
CATTGCGAGCCGCAGT-1	True	True	True
ACCAGGACAGGAACTG-1	True	True	True
GATTGCAGTGTTAGCA-1	True	True	True
GATGAGGGTAGGTTTG-1	True	True	True
TAAGTAGCAATGAAGC-1	True	True	True
GGCATGGAGGAACGGT-1	True	True	True
AACAAGCCATTGTCAG-1	True	True	True
GCTTACCTCGTTTCCA-1	True	True	True
GGGTGTTGTTGCAGTA-1	True	True	True
GGTACTTAGGAGTCTT-1	False	True	True
CCTTCGTAGCCGCTTT-1	True	True	True
CCTTATGTCACGTTAA-1	True	True	True
GAAGTGATCTAAGTCA-1	True	True	True
GGTAATTGTCACTCGC-1	False	False	True
TCCCGTTAGACAAACG-1	True	True	True
GTGCACGGTGTGTCCC-1	True	True	True
GGAGTGAGTTTCCTCC-1	True	True	True
GCGCTAGGTTTCCTCC-1	True	True	True
AATTGCCAGGATTGAG-1	True	True	True
ATTCATGAGGTCCTAG-1	True	True	True
GATTAGCTCTTGGATA-1	True	True	True
TCGATTAAGATGGACA-1	True	True	True
GTGAGGAGTAGGTTTG-1	True	True	True
TTGCACACAATGCCCG-1	True	True	True
CCTCCTGAGGAGGCAT-1	False	True	True
GGTTAATGTAACAGGG-1	True	True	True
CTATAACCAATATAGG-1	True	True	True
TTTCCGGGTTAGTGAT-1	True	True	True
AGACTATGTAATGGCC-1	True	True	True
AACTAGCTCAAACCGT-1	False	True	True
TCATTGCGTATTCGCT-1	True	True	True
TACGGTTAGCAATAGG-1	True	True	True
CCATCACTCATTAGGC-1	True	True	True
ATGCGATTCGGTTCCT-1	True	True	True
AGAGATTAGGGTGAAC-1	True	True	True
CGAATATGTTAAGCTG-1	False	True	True
ATGGCCGGTCTAACCT-1	True	True	True
TAGCCTCTCGTCAAGT-1	True	True	True
CGGACCTAGACAGGCG-1	True	True	True
AGGCGGATCACGTTAA-1	True	True	True
GATTCGCCATTCAGCA-1	True	True	True
GTTGCTGAGGACCTCA-1	True	True	True
TTCCTCAAGACAACAG-1	True	True	True
